Poker Hand #HD50931703: Hold'em No Limit ($0.01/$0.02) - 2024/05/21 20:58:21
Table 'NLHYellow5' 6-max Seat #1 is the button
Seat 1: Hero ($3.75 in chips)
Seat 2: 6e117840 ($1.76 in chips)
Seat 4: 3989b5f1 ($4.35 in chips)
Seat 5: 68bed66e ($1.9 in chips)
Seat 6: aab27c0e ($2.04 in chips)
6e117840: posts small blind $0.01
3989b5f1: posts big blind $0.02
*** HOLE CARDS ***
Dealt to Hero [3c 8s]
Dealt to 6e117840 
Dealt to 3989b5f1 
Dealt to 68bed66e 
Dealt to aab27c0e 
68bed66e: folds
aab27c0e: folds
Hero: folds
6e117840: raises $0.02 to $0.04
3989b5f1: calls $0.02
*** FLOP *** [8h 3s 2d]
6e117840: checks
3989b5f1: checks
*** TURN *** [8h 3s 2d] [Ts]
6e117840: checks
3989b5f1: checks
*** RIVER *** [8h 3s 2d Ts] [8d]
6e117840: checks
3989b5f1: checks
6e117840: shows [Ah 7s] (Pair of Eights)
3989b5f1: shows [Ad 7h] (Pair of Eights)
*** SHOWDOWN ***
6e117840 collected $0.04 from pot
3989b5f1 collected $0.04 from pot
*** SUMMARY ***
Total pot $0.08 | Rake $0 | Jackpot $0 | Bingo $0 | Fortune $0 | Tax $0
Board [8h 3s 2d Ts 8d]
Seat 1: Hero (button) folded before Flop (didn't bet)
Seat 2: 6e117840 (small blind) showed [Ah 7s] and won ($0.04) with Pair of Eights
Seat 4: 3989b5f1 (big blind) showed [Ad 7h] and won ($0.04) with Pair of Eights
Seat 5: 68bed66e folded before Flop (didn't bet)
Seat 6: aab27c0e folded before Flop (didn't bet)


Poker Hand #HD50931687: Hold'em No Limit ($0.01/$0.02) - 2024/05/21 20:57:53
Table 'NLHYellow5' 6-max Seat #6 is the button
Seat 1: Hero ($3.76 in chips)
Seat 2: 6e117840 ($1.73 in chips)
Seat 4: 3989b5f1 ($4.35 in chips)
Seat 5: 68bed66e ($1.92 in chips)
Seat 6: aab27c0e ($2.04 in chips)
Hero: posts small blind $0.01
6e117840: posts big blind $0.02
*** HOLE CARDS ***
Dealt to Hero [9d 2c]
Dealt to 6e117840 
Dealt to 3989b5f1 
Dealt to 68bed66e 
Dealt to aab27c0e 
3989b5f1: folds
68bed66e: calls $0.02
aab27c0e: folds
Hero: folds
6e117840: checks
*** FLOP *** [Ad 6h 8c]
6e117840: checks
68bed66e: checks
*** TURN *** [Ad 6h 8c] [5h]
6e117840: bets $0.04
68bed66e: folds
Uncalled bet ($0.04) returned to 6e117840
*** SHOWDOWN ***
6e117840 collected $0.05 from pot
*** SUMMARY ***
Total pot $0.05 | Rake $0 | Jackpot $0 | Bingo $0 | Fortune $0 | Tax $0
Board [Ad 6h 8c 5h]
Seat 1: Hero (small blind) folded before Flop
Seat 2: 6e117840 (big blind) won ($0.05)
Seat 4: 3989b5f1 folded before Flop (didn't bet)
Seat 5: 68bed66e folded on the Turn
Seat 6: aab27c0e (button) folded before Flop (didn't bet)


Poker Hand #HD50931681: Hold'em No Limit ($0.01/$0.02) - 2024/05/21 20:57:38
Table 'NLHYellow5' 6-max Seat #5 is the button
Seat 1: Hero ($3.78 in chips)
Seat 2: 6e117840 ($1.7 in chips)
Seat 4: 3989b5f1 ($4.35 in chips)
Seat 5: 68bed66e ($1.92 in chips)
Seat 6: aab27c0e ($2.05 in chips)
aab27c0e: posts small blind $0.01
Hero: posts big blind $0.02
*** HOLE CARDS ***
Dealt to Hero [Qd 4h]
Dealt to 6e117840 
Dealt to 3989b5f1 
Dealt to 68bed66e 
Dealt to aab27c0e 
6e117840: raises $0.02 to $0.04
3989b5f1: folds
68bed66e: folds
aab27c0e: folds
Hero: folds
Uncalled bet ($0.02) returned to 6e117840
*** SHOWDOWN ***
6e117840 collected $0.05 from pot
*** SUMMARY ***
Total pot $0.05 | Rake $0 | Jackpot $0 | Bingo $0 | Fortune $0 | Tax $0
Seat 1: Hero (big blind) folded before Flop
Seat 2: 6e117840 collected ($0.05)
Seat 4: 3989b5f1 folded before Flop (didn't bet)
Seat 5: 68bed66e (button) folded before Flop (didn't bet)
Seat 6: aab27c0e (small blind) folded before Flop


Poker Hand #HD50931669: Hold'em No Limit ($0.01/$0.02) - 2024/05/21 20:57:15
Table 'NLHYellow5' 6-max Seat #4 is the button
Seat 1: Hero ($3.78 in chips)
Seat 2: 6e117840 ($1.7 in chips)
Seat 4: 3989b5f1 ($4.35 in chips)
Seat 5: 68bed66e ($1.9 in chips)
Seat 6: aab27c0e ($2.07 in chips)
68bed66e: posts small blind $0.01
aab27c0e: posts big blind $0.02
*** HOLE CARDS ***
Dealt to Hero [3c 4c]
Dealt to 6e117840 
Dealt to 3989b5f1 
Dealt to 68bed66e 
Dealt to aab27c0e 
Hero: folds
6e117840: folds
3989b5f1: folds
68bed66e: calls $0.01
aab27c0e: checks
*** FLOP *** [2h 6h Ks]
68bed66e: checks
aab27c0e: checks
*** TURN *** [2h 6h Ks] [Jh]
68bed66e: bets $0.03
aab27c0e: folds
Uncalled bet ($0.03) returned to 68bed66e
*** SHOWDOWN ***
68bed66e collected $0.04 from pot
*** SUMMARY ***
Total pot $0.04 | Rake $0 | Jackpot $0 | Bingo $0 | Fortune $0 | Tax $0
Board [2h 6h Ks Jh]
Seat 1: Hero folded before Flop (didn't bet)
Seat 2: 6e117840 folded before Flop (didn't bet)
Seat 4: 3989b5f1 (button) folded before Flop (didn't bet)
Seat 5: 68bed66e (small blind) won ($0.04)
Seat 6: aab27c0e (big blind) folded on the Turn


Poker Hand #HD50931644: Hold'em No Limit ($0.01/$0.02) - 2024/05/21 20:56:22
Table 'NLHYellow5' 6-max Seat #2 is the button
Seat 1: Hero ($3.78 in chips)
Seat 2: 6e117840 ($1.7 in chips)
Seat 4: 3989b5f1 ($4.36 in chips)
Seat 5: 68bed66e ($2.01 in chips)
Seat 6: aab27c0e ($1.96 in chips)
3989b5f1: posts small blind $0.01
68bed66e: posts big blind $0.02
*** HOLE CARDS ***
Dealt to Hero [Qs 2h]
Dealt to 6e117840 
Dealt to 3989b5f1 
Dealt to 68bed66e 
Dealt to aab27c0e 
aab27c0e: raises $0.04 to $0.06
Hero: folds
6e117840: folds
3989b5f1: folds
68bed66e: calls $0.04
*** FLOP *** [6s 3h 7c]
68bed66e: bets $0.05
aab27c0e: calls $0.05
*** TURN *** [6s 3h 7c] [5d]
68bed66e: checks
aab27c0e: checks
*** RIVER *** [6s 3h 7c 5d] [Qh]
68bed66e: checks
aab27c0e: bets $0.06
68bed66e: folds
Uncalled bet ($0.06) returned to aab27c0e
aab27c0e: shows [As] (Ace-High)
*** SHOWDOWN ***
aab27c0e collected $0.22 from pot
*** SUMMARY ***
Total pot $0.23 | Rake $0.01 | Jackpot $0 | Bingo $0 | Fortune $0 | Tax $0
Board [6s 3h 7c 5d Qh]
Seat 1: Hero folded before Flop (didn't bet)
Seat 2: 6e117840 (button) folded before Flop (didn't bet)
Seat 4: 3989b5f1 (small blind) folded before Flop
Seat 5: 68bed66e (big blind) folded on the River
Seat 6: aab27c0e showed [As] and won ($0.22)


Poker Hand #HD50931633: Hold'em No Limit ($0.01/$0.02) - 2024/05/21 20:56:01
Table 'NLHYellow5' 6-max Seat #1 is the button
Seat 1: Hero ($3.78 in chips)
Seat 2: 6e117840 ($1.71 in chips)
Seat 4: 3989b5f1 ($4.35 in chips)
Seat 5: 68bed66e ($2.01 in chips)
Seat 6: aab27c0e ($1.96 in chips)
6e117840: posts small blind $0.01
3989b5f1: posts big blind $0.02
*** HOLE CARDS ***
Dealt to Hero [7s Qd]
Dealt to 6e117840 
Dealt to 3989b5f1 
Dealt to 68bed66e 
Dealt to aab27c0e 
68bed66e: folds
aab27c0e: folds
Hero: folds
6e117840: folds
Uncalled bet ($0.01) returned to 3989b5f1
*** SHOWDOWN ***
3989b5f1 collected $0.02 from pot
*** SUMMARY ***
Total pot $0.02 | Rake $0 | Jackpot $0 | Bingo $0 | Fortune $0 | Tax $0
Seat 1: Hero (button) folded before Flop (didn't bet)
Seat 2: 6e117840 (small blind) folded before Flop
Seat 4: 3989b5f1 (big blind) collected ($0.02)
Seat 5: 68bed66e folded before Flop (didn't bet)
Seat 6: aab27c0e folded before Flop (didn't bet)


Poker Hand #HD50931627: Hold'em No Limit ($0.01/$0.02) - 2024/05/21 20:55:50
Table 'NLHYellow5' 6-max Seat #6 is the button
Seat 1: Hero ($3.79 in chips)
Seat 2: 6e117840 ($1.73 in chips)
Seat 4: 3989b5f1 ($4.35 in chips)
Seat 5: 68bed66e ($2.01 in chips)
Seat 6: aab27c0e ($1.93 in chips)
Hero: posts small blind $0.01
6e117840: posts big blind $0.02
*** HOLE CARDS ***
Dealt to Hero [2s Td]
Dealt to 6e117840 
Dealt to 3989b5f1 
Dealt to 68bed66e 
Dealt to aab27c0e 
3989b5f1: folds
68bed66e: folds
aab27c0e: raises $0.04 to $0.06
Hero: folds
6e117840: folds
Uncalled bet ($0.04) returned to aab27c0e
*** SHOWDOWN ***
aab27c0e collected $0.05 from pot
*** SUMMARY ***
Total pot $0.05 | Rake $0 | Jackpot $0 | Bingo $0 | Fortune $0 | Tax $0
Seat 1: Hero (small blind) folded before Flop
Seat 2: 6e117840 (big blind) folded before Flop
Seat 4: 3989b5f1 folded before Flop (didn't bet)
Seat 5: 68bed66e folded before Flop (didn't bet)
Seat 6: aab27c0e (button) collected ($0.05)


Poker Hand #HD50931595: Hold'em No Limit ($0.01/$0.02) - 2024/05/21 20:54:36
Table 'NLHYellow5' 6-max Seat #5 is the button
Seat 1: Hero ($3.67 in chips)
Seat 2: 6e117840 ($1.8 in chips)
Seat 4: 3989b5f1 ($4.37 in chips)
Seat 5: 68bed66e ($2.03 in chips)
Seat 6: aab27c0e ($1.95 in chips)
aab27c0e: posts small blind $0.01
Hero: posts big blind $0.02
*** HOLE CARDS ***
Dealt to Hero [Qh Jc]
Dealt to 6e117840 
Dealt to 3989b5f1 
Dealt to 68bed66e 
Dealt to aab27c0e 
6e117840: calls $0.02
3989b5f1: calls $0.02
68bed66e: calls $0.02
aab27c0e: calls $0.01
Hero: checks
*** FLOP *** [9h Qs 3c]
aab27c0e: checks
Hero: bets $0.05
6e117840: calls $0.05
3989b5f1: folds
68bed66e: folds
aab27c0e: folds
*** TURN *** [9h Qs 3c] [6s]
Hero: bets $0.15
6e117840: folds
Uncalled bet ($0.15) returned to Hero
*** SHOWDOWN ***
Hero collected $0.19 from pot
*** SUMMARY ***
Total pot $0.2 | Rake $0.01 | Jackpot $0 | Bingo $0 | Fortune $0 | Tax $0
Board [9h Qs 3c 6s]
Seat 1: Hero (big blind) won ($0.19)
Seat 2: 6e117840 folded on the Turn
Seat 4: 3989b5f1 folded on the Flop
Seat 5: 68bed66e (button) folded on the Flop
Seat 6: aab27c0e (small blind) folded on the Flop


Poker Hand #HD50931578: Hold'em No Limit ($0.01/$0.02) - 2024/05/21 20:54:06
Table 'NLHYellow5' 6-max Seat #4 is the button
Seat 1: Hero ($3.67 in chips)
Seat 2: 6e117840 ($1.8 in chips)
Seat 4: 3989b5f1 ($4.37 in chips)
Seat 5: 68bed66e ($2.08 in chips)
Seat 6: aab27c0e ($1.9 in chips)
68bed66e: posts small blind $0.01
aab27c0e: posts big blind $0.02
*** HOLE CARDS ***
Dealt to Hero [5d 2c]
Dealt to 6e117840 
Dealt to 3989b5f1 
Dealt to 68bed66e 
Dealt to aab27c0e 
Hero: folds
6e117840: folds
3989b5f1: folds
68bed66e: calls $0.01
aab27c0e: raises $0.03 to $0.05
68bed66e: calls $0.03
*** FLOP *** [Ks Ts 3d]
68bed66e: checks
aab27c0e: bets $0.08
68bed66e: folds
Uncalled bet ($0.08) returned to aab27c0e
*** SHOWDOWN ***
aab27c0e collected $0.1 from pot
*** SUMMARY ***
Total pot $0.1 | Rake $0 | Jackpot $0 | Bingo $0 | Fortune $0 | Tax $0
Board [Ks Ts 3d]
Seat 1: Hero folded before Flop (didn't bet)
Seat 2: 6e117840 folded before Flop (didn't bet)
Seat 4: 3989b5f1 (button) folded before Flop (didn't bet)
Seat 5: 68bed66e (small blind) folded on the Flop
Seat 6: aab27c0e (big blind) won ($0.1)


Poker Hand #HD50931544: Hold'em No Limit ($0.01/$0.02) - 2024/05/21 20:52:45
Table 'NLHYellow5' 6-max Seat #3 is the button
Seat 1: Hero ($4.45 in chips)
Seat 2: 6e117840 ($1.8 in chips)
Seat 3: 1120325c ($0.57 in chips)
Seat 4: 3989b5f1 ($4.38 in chips)
Seat 5: 68bed66e ($0.78 in chips)
Seat 6: aab27c0e ($1.96 in chips)
3989b5f1: posts small blind $0.01
68bed66e: posts big blind $0.02
*** HOLE CARDS ***
Dealt to Hero [5d 6d]
Dealt to 6e117840 
Dealt to 1120325c 
Dealt to 3989b5f1 
Dealt to 68bed66e 
Dealt to aab27c0e 
aab27c0e: raises $0.04 to $0.06
Hero: calls $0.06
6e117840: folds
1120325c: calls $0.06
3989b5f1: folds
68bed66e: calls $0.04
*** FLOP *** [7c 6s 8h]
68bed66e: bets $0.13
aab27c0e: folds
Hero: calls $0.13
1120325c: raises $0.38 to $0.51 and is all-in
68bed66e: raises $0.21 to $0.72 and is all-in
Hero: calls $0.59
68bed66e: shows [Th 9d] (Tens-High Straight)
Hero: shows [5d 6d] (Pair of Sixes)
1120325c: shows [6h 7h] (Pair of Sevens and Pair of Sixes)
*** TURN *** [7c 6s 8h] [2c]
*** RIVER *** [7c 6s 8h 2c] [Kh]
*** SHOWDOWN ***
68bed66e collected $1.68 from pot
68bed66e collected $0.4 from pot
*** SUMMARY ***
Total pot $2.2 | Rake $0.1 | Jackpot $0.02 | Bingo $0 | Fortune $0 | Tax $0
Board [7c 6s 8h 2c Kh]
Seat 1: Hero showed [5d 6d] and lost with Pair of Sixes
Seat 2: 6e117840 folded before Flop (didn't bet)
Seat 3: 1120325c (button) showed [6h 7h] and lost with Pair of Sevens and Pair of Sixes
Seat 4: 3989b5f1 (small blind) folded before Flop
Seat 5: 68bed66e (big blind) showed [Th 9d] and won ($2.08) with Tens-High Straight
Seat 6: aab27c0e folded on the Flop


Poker Hand #HD50931525: Hold'em No Limit ($0.01/$0.02) - 2024/05/21 20:52:07
Table 'NLHYellow5' 6-max Seat #2 is the button
Seat 1: Hero ($4.45 in chips)
Seat 2: 6e117840 ($1.8 in chips)
Seat 3: 1120325c ($0.55 in chips)
Seat 4: 3989b5f1 ($4.4 in chips)
Seat 5: 68bed66e ($0.78 in chips)
Seat 6: aab27c0e ($1.96 in chips)
1120325c: posts small blind $0.01
3989b5f1: posts big blind $0.02
*** HOLE CARDS ***
Dealt to Hero [4c 5d]
Dealt to 6e117840 
Dealt to 1120325c 
Dealt to 3989b5f1 
Dealt to 68bed66e 
Dealt to aab27c0e 
68bed66e: folds
aab27c0e: folds
Hero: folds
6e117840: folds
1120325c: calls $0.01
3989b5f1: checks
*** FLOP *** [3s 9d Js]
1120325c: checks
3989b5f1: checks
*** TURN *** [3s 9d Js] [4d]
1120325c: checks
3989b5f1: checks
*** RIVER *** [3s 9d Js 4d] [9c]
1120325c: checks
3989b5f1: checks
1120325c: shows [Qc 7s] (Pair of Nines)
3989b5f1: shows [6c 2s] (Pair of Nines)
*** SHOWDOWN ***
1120325c collected $0.04 from pot
*** SUMMARY ***
Total pot $0.04 | Rake $0 | Jackpot $0 | Bingo $0 | Fortune $0 | Tax $0
Board [3s 9d Js 4d 9c]
Seat 1: Hero folded before Flop (didn't bet)
Seat 2: 6e117840 (button) folded before Flop (didn't bet)
Seat 3: 1120325c (small blind) showed [Qc 7s] and won ($0.04) with Pair of Nines
Seat 4: 3989b5f1 (big blind) showed [6c 2s] and lost with Pair of Nines
Seat 5: 68bed66e folded before Flop (didn't bet)
Seat 6: aab27c0e folded before Flop (didn't bet)


Poker Hand #HD50931510: Hold'em No Limit ($0.01/$0.02) - 2024/05/21 20:51:29
Table 'NLHYellow5' 6-max Seat #1 is the button
Seat 1: Hero ($4.45 in chips)
Seat 2: 6e117840 ($1.81 in chips)
Seat 3: 1120325c ($0.57 in chips)
Seat 4: 3989b5f1 ($4.4 in chips)
Seat 5: 68bed66e ($0.75 in chips)
Seat 6: aab27c0e ($1.96 in chips)
6e117840: posts small blind $0.01
1120325c: posts big blind $0.02
*** HOLE CARDS ***
Dealt to Hero [Kc 3d]
Dealt to 6e117840 
Dealt to 1120325c 
Dealt to 3989b5f1 
Dealt to 68bed66e 
Dealt to aab27c0e 
3989b5f1: folds
68bed66e: calls $0.02
aab27c0e: folds
Hero: folds
6e117840: folds
1120325c: checks
*** FLOP *** [Kd 8s Qd]
1120325c: checks
68bed66e: checks
*** TURN *** [Kd 8s Qd] [2c]
1120325c: checks
68bed66e: bets $0.03
1120325c: folds
Uncalled bet ($0.03) returned to 68bed66e
*** SHOWDOWN ***
68bed66e collected $0.05 from pot
*** SUMMARY ***
Total pot $0.05 | Rake $0 | Jackpot $0 | Bingo $0 | Fortune $0 | Tax $0
Board [Kd 8s Qd 2c]
Seat 1: Hero (button) folded before Flop (didn't bet)
Seat 2: 6e117840 (small blind) folded before Flop
Seat 3: 1120325c (big blind) folded on the Turn
Seat 4: 3989b5f1 folded before Flop (didn't bet)
Seat 5: 68bed66e won ($0.05)
Seat 6: aab27c0e folded before Flop (didn't bet)


Poker Hand #HD50931484: Hold'em No Limit ($0.01/$0.02) - 2024/05/21 20:50:17
Table 'NLHYellow5' 6-max Seat #6 is the button
Seat 1: Hero ($5.01 in chips)
Seat 2: 6e117840 ($1.83 in chips)
Seat 3: 1120325c ($0.57 in chips)
Seat 4: 3989b5f1 ($3.84 in chips)
Seat 5: 68bed66e ($0.75 in chips)
Seat 6: aab27c0e ($2.01 in chips)
Hero: posts small blind $0.01
6e117840: posts big blind $0.02
*** HOLE CARDS ***
Dealt to Hero [Kd Ac]
Dealt to 6e117840 
Dealt to 1120325c 
Dealt to 3989b5f1 
Dealt to 68bed66e 
Dealt to aab27c0e 
1120325c: folds
3989b5f1: raises $0.03 to $0.05
68bed66e: folds
aab27c0e: calls $0.05
Hero: raises $0.19 to $0.24
6e117840: folds
3989b5f1: raises $0.32 to $0.56
aab27c0e: folds
Hero: calls $0.32
*** FLOP *** [7d 3s Qd]
Hero: checks
3989b5f1: bets $0.4
Hero: folds
Uncalled bet ($0.4) returned to 3989b5f1
*** SHOWDOWN ***
3989b5f1 collected $1.12 from pot
*** SUMMARY ***
Total pot $1.19 | Rake $0.05 | Jackpot $0.02 | Bingo $0 | Fortune $0 | Tax $0
Board [7d 3s Qd]
Seat 1: Hero (small blind) folded on the Flop
Seat 2: 6e117840 (big blind) folded before Flop
Seat 3: 1120325c folded before Flop (didn't bet)
Seat 4: 3989b5f1 won ($1.12)
Seat 5: 68bed66e folded before Flop (didn't bet)
Seat 6: aab27c0e (button) folded before Flop


Poker Hand #HD50931473: Hold'em No Limit ($0.01/$0.02) - 2024/05/21 20:49:41
Table 'NLHYellow5' 6-max Seat #5 is the button
Seat 1: Hero ($5.03 in chips)
Seat 2: 6e117840 ($1.83 in chips)
Seat 3: 1120325c ($0.75 in chips)
Seat 4: 3989b5f1 ($3.84 in chips)
Seat 5: 68bed66e ($0.56 in chips)
Seat 6: aab27c0e ($2.02 in chips)
aab27c0e: posts small blind $0.01
Hero: posts big blind $0.02
*** HOLE CARDS ***
Dealt to Hero [3s Td]
Dealt to 6e117840 
Dealt to 1120325c 
Dealt to 3989b5f1 
Dealt to 68bed66e 
Dealt to aab27c0e 
6e117840: folds
1120325c: raises $0.04 to $0.06
3989b5f1: folds
68bed66e: calls $0.06
aab27c0e: folds
Hero: folds
*** FLOP *** [6h 8s 7s]
1120325c: bets $0.12
68bed66e: calls $0.12
*** TURN *** [6h 8s 7s] [5c]
1120325c: checks
68bed66e: bets $0.2
1120325c: folds
Uncalled bet ($0.2) returned to 68bed66e
*** SHOWDOWN ***
68bed66e collected $0.37 from pot
*** SUMMARY ***
Total pot $0.39 | Rake $0.02 | Jackpot $0 | Bingo $0 | Fortune $0 | Tax $0
Board [6h 8s 7s 5c]
Seat 1: Hero (big blind) folded before Flop
Seat 2: 6e117840 folded before Flop (didn't bet)
Seat 3: 1120325c folded on the Turn
Seat 4: 3989b5f1 folded before Flop (didn't bet)
Seat 5: 68bed66e (button) won ($0.37)
Seat 6: aab27c0e (small blind) folded before Flop


Poker Hand #HD50931454: Hold'em No Limit ($0.01/$0.02) - 2024/05/21 20:48:47
Table 'NLHYellow5' 6-max Seat #4 is the button
Seat 1: Hero ($5.03 in chips)
Seat 2: 6e117840 ($1.83 in chips)
Seat 3: 1120325c ($0.75 in chips)
Seat 4: 3989b5f1 ($4.13 in chips)
Seat 5: 68bed66e ($0.29 in chips)
Seat 6: aab27c0e ($2.04 in chips)
68bed66e: posts small blind $0.01
aab27c0e: posts big blind $0.02
*** HOLE CARDS ***
Dealt to Hero [Th 8h]
Dealt to 6e117840 
Dealt to 1120325c 
Dealt to 3989b5f1 
Dealt to 68bed66e 
Dealt to aab27c0e 
Hero: folds
6e117840: folds
1120325c: folds
3989b5f1: raises $0.03 to $0.05
68bed66e: calls $0.04
aab27c0e: folds
*** FLOP *** [Qc Qs 2c]
68bed66e: checks
3989b5f1: checks
*** TURN *** [Qc Qs 2c] [8s]
68bed66e: checks
3989b5f1: bets $0.04
68bed66e: calls $0.04
*** RIVER *** [Qc Qs 2c 8s] [6c]
68bed66e: bets $0.2 and is all-in
3989b5f1: calls $0.2
68bed66e: shows [Qd Kh] (Three Queens)
3989b5f1: shows [9h 9s] (Pair of Queens and Pair of Nines)
*** SHOWDOWN ***
68bed66e collected $0.56 from pot
*** SUMMARY ***
Total pot $0.6 | Rake $0.02 | Jackpot $0.02 | Bingo $0 | Fortune $0 | Tax $0
Board [Qc Qs 2c 8s 6c]
Seat 1: Hero folded before Flop (didn't bet)
Seat 2: 6e117840 folded before Flop (didn't bet)
Seat 3: 1120325c folded before Flop (didn't bet)
Seat 4: 3989b5f1 (button) showed [9h 9s] and lost with Pair of Queens and Pair of Nines
Seat 5: 68bed66e (small blind) showed [Qd Kh] and won ($0.56) with Three Queens
Seat 6: aab27c0e (big blind) folded before Flop


Poker Hand #HD50931450: Hold'em No Limit ($0.01/$0.02) - 2024/05/21 20:48:37
Table 'NLHYellow5' 6-max Seat #3 is the button
Seat 1: Hero ($5.03 in chips)
Seat 2: 6e117840 ($1.83 in chips)
Seat 3: 1120325c ($0.75 in chips)
Seat 4: 3989b5f1 ($4.14 in chips)
Seat 5: 68bed66e ($0.28 in chips)
Seat 6: aab27c0e ($2.04 in chips)
3989b5f1: posts small blind $0.01
68bed66e: posts big blind $0.02
*** HOLE CARDS ***
Dealt to Hero [7h 2c]
Dealt to 6e117840 
Dealt to 1120325c 
Dealt to 3989b5f1 
Dealt to 68bed66e 
Dealt to aab27c0e 
aab27c0e: folds
Hero: folds
6e117840: folds
1120325c: folds
3989b5f1: folds
Uncalled bet ($0.01) returned to 68bed66e
*** SHOWDOWN ***
68bed66e collected $0.02 from pot
*** SUMMARY ***
Total pot $0.02 | Rake $0 | Jackpot $0 | Bingo $0 | Fortune $0 | Tax $0
Seat 1: Hero folded before Flop (didn't bet)
Seat 2: 6e117840 folded before Flop (didn't bet)
Seat 3: 1120325c (button) folded before Flop (didn't bet)
Seat 4: 3989b5f1 (small blind) folded before Flop
Seat 5: 68bed66e (big blind) collected ($0.02)
Seat 6: aab27c0e folded before Flop (didn't bet)


Poker Hand #HD50931438: Hold'em No Limit ($0.01/$0.02) - 2024/05/21 20:48:07
Table 'NLHYellow5' 6-max Seat #2 is the button
Seat 1: Hero ($5.03 in chips)
Seat 2: 6e117840 ($1.83 in chips)
Seat 3: 1120325c ($0.76 in chips)
Seat 4: 3989b5f1 ($4.16 in chips)
Seat 5: 68bed66e ($0.25 in chips)
Seat 6: aab27c0e ($2.04 in chips)
1120325c: posts small blind $0.01
3989b5f1: posts big blind $0.02
*** HOLE CARDS ***
Dealt to Hero [5s 2h]
Dealt to 6e117840 
Dealt to 1120325c 
Dealt to 3989b5f1 
Dealt to 68bed66e 
Dealt to aab27c0e 
68bed66e: calls $0.02
aab27c0e: folds
Hero: folds
6e117840: folds
1120325c: folds
3989b5f1: checks
*** FLOP *** [7d Jd 6c]
3989b5f1: checks
68bed66e: checks
*** TURN *** [7d Jd 6c] [Qd]
3989b5f1: checks
68bed66e: bets $0.05
3989b5f1: folds
Uncalled bet ($0.05) returned to 68bed66e
*** SHOWDOWN ***
68bed66e collected $0.05 from pot
*** SUMMARY ***
Total pot $0.05 | Rake $0 | Jackpot $0 | Bingo $0 | Fortune $0 | Tax $0
Board [7d Jd 6c Qd]
Seat 1: Hero folded before Flop (didn't bet)
Seat 2: 6e117840 (button) folded before Flop (didn't bet)
Seat 3: 1120325c (small blind) folded before Flop
Seat 4: 3989b5f1 (big blind) folded on the Turn
Seat 5: 68bed66e won ($0.05)
Seat 6: aab27c0e folded before Flop (didn't bet)


Poker Hand #HD50931434: Hold'em No Limit ($0.01/$0.02) - 2024/05/21 20:47:55
Table 'NLHYellow5' 6-max Seat #1 is the button
Seat 1: Hero ($5.03 in chips)
Seat 2: 6e117840 ($1.84 in chips)
Seat 3: 1120325c ($0.75 in chips)
Seat 4: 3989b5f1 ($4.16 in chips)
Seat 5: 68bed66e ($0.25 in chips)
Seat 6: aab27c0e ($2.04 in chips)
6e117840: posts small blind $0.01
1120325c: posts big blind $0.02
*** HOLE CARDS ***
Dealt to Hero [5s 4h]
Dealt to 6e117840 
Dealt to 1120325c 
Dealt to 3989b5f1 
Dealt to 68bed66e 
Dealt to aab27c0e 
3989b5f1: folds
68bed66e: folds
aab27c0e: folds
Hero: folds
6e117840: folds
Uncalled bet ($0.01) returned to 1120325c
*** SHOWDOWN ***
1120325c collected $0.02 from pot
*** SUMMARY ***
Total pot $0.02 | Rake $0 | Jackpot $0 | Bingo $0 | Fortune $0 | Tax $0
Seat 1: Hero (button) folded before Flop (didn't bet)
Seat 2: 6e117840 (small blind) folded before Flop
Seat 3: 1120325c (big blind) collected ($0.02)
Seat 4: 3989b5f1 folded before Flop (didn't bet)
Seat 5: 68bed66e folded before Flop (didn't bet)
Seat 6: aab27c0e folded before Flop (didn't bet)


Poker Hand #HD50931424: Hold'em No Limit ($0.01/$0.02) - 2024/05/21 20:47:23
Table 'NLHYellow5' 6-max Seat #6 is the button
Seat 1: Hero ($5.04 in chips)
Seat 2: 6e117840 ($1.86 in chips)
Seat 3: 1120325c ($0.75 in chips)
Seat 4: 3989b5f1 ($4.16 in chips)
Seat 5: 68bed66e ($0.31 in chips)
Seat 6: aab27c0e ($1.95 in chips)
Hero: posts small blind $0.01
6e117840: posts big blind $0.02
*** HOLE CARDS ***
Dealt to Hero [2h Qh]
Dealt to 6e117840 
Dealt to 1120325c 
Dealt to 3989b5f1 
Dealt to 68bed66e 
Dealt to aab27c0e 
1120325c: folds
3989b5f1: folds
68bed66e: calls $0.02
aab27c0e: raises $0.04 to $0.06
Hero: folds
6e117840: folds
68bed66e: calls $0.04
*** FLOP *** [Ts Th 6d]
68bed66e: checks
aab27c0e: bets $0.08
68bed66e: folds
Uncalled bet ($0.08) returned to aab27c0e
*** SHOWDOWN ***
aab27c0e collected $0.15 from pot
*** SUMMARY ***
Total pot $0.15 | Rake $0 | Jackpot $0 | Bingo $0 | Fortune $0 | Tax $0
Board [Ts Th 6d]
Seat 1: Hero (small blind) folded before Flop
Seat 2: 6e117840 (big blind) folded before Flop
Seat 3: 1120325c folded before Flop (didn't bet)
Seat 4: 3989b5f1 folded before Flop (didn't bet)
Seat 5: 68bed66e folded on the Flop
Seat 6: aab27c0e (button) won ($0.15)


Poker Hand #HD50931420: Hold'em No Limit ($0.01/$0.02) - 2024/05/21 20:47:11
Table 'NLHYellow5' 6-max Seat #5 is the button
Seat 1: Hero ($5.06 in chips)
Seat 2: 6e117840 ($1.86 in chips)
Seat 3: 1120325c ($0.75 in chips)
Seat 4: 3989b5f1 ($4.13 in chips)
Seat 5: 68bed66e ($0.31 in chips)
Seat 6: aab27c0e ($1.96 in chips)
aab27c0e: posts small blind $0.01
Hero: posts big blind $0.02
*** HOLE CARDS ***
Dealt to Hero [4c Td]
Dealt to 6e117840 
Dealt to 1120325c 
Dealt to 3989b5f1 
Dealt to 68bed66e 
Dealt to aab27c0e 
6e117840: folds
1120325c: folds
3989b5f1: raises $0.03 to $0.05
68bed66e: folds
aab27c0e: folds
Hero: folds
Uncalled bet ($0.03) returned to 3989b5f1
*** SHOWDOWN ***
3989b5f1 collected $0.05 from pot
*** SUMMARY ***
Total pot $0.05 | Rake $0 | Jackpot $0 | Bingo $0 | Fortune $0 | Tax $0
Seat 1: Hero (big blind) folded before Flop
Seat 2: 6e117840 folded before Flop (didn't bet)
Seat 3: 1120325c folded before Flop (didn't bet)
Seat 4: 3989b5f1 collected ($0.05)
Seat 5: 68bed66e (button) folded before Flop (didn't bet)
Seat 6: aab27c0e (small blind) folded before Flop


Poker Hand #HD50931410: Hold'em No Limit ($0.01/$0.02) - 2024/05/21 20:46:43
Table 'NLHYellow5' 6-max Seat #4 is the button
Seat 1: Hero ($5.06 in chips)
Seat 2: 6e117840 ($1.86 in chips)
Seat 3: 1120325c ($0.75 in chips)
Seat 4: 3989b5f1 ($4.13 in chips)
Seat 5: 68bed66e ($0.29 in chips)
Seat 6: aab27c0e ($1.98 in chips)
68bed66e: posts small blind $0.01
aab27c0e: posts big blind $0.02
*** HOLE CARDS ***
Dealt to Hero [Tc 9d]
Dealt to 6e117840 
Dealt to 1120325c 
Dealt to 3989b5f1 
Dealt to 68bed66e 
Dealt to aab27c0e 
Hero: folds
6e117840: folds
1120325c: folds
3989b5f1: folds
68bed66e: calls $0.01
aab27c0e: checks
*** FLOP *** [3d As 7d]
68bed66e: bets $0.04
aab27c0e: folds
Uncalled bet ($0.04) returned to 68bed66e
*** SHOWDOWN ***
68bed66e collected $0.04 from pot
*** SUMMARY ***
Total pot $0.04 | Rake $0 | Jackpot $0 | Bingo $0 | Fortune $0 | Tax $0
Board [3d As 7d]
Seat 1: Hero folded before Flop (didn't bet)
Seat 2: 6e117840 folded before Flop (didn't bet)
Seat 3: 1120325c folded before Flop (didn't bet)
Seat 4: 3989b5f1 (button) folded before Flop (didn't bet)
Seat 5: 68bed66e (small blind) won ($0.04)
Seat 6: aab27c0e (big blind) folded on the Flop


Poker Hand #HD50931395: Hold'em No Limit ($0.01/$0.02) - 2024/05/21 20:45:59
Table 'NLHYellow5' 6-max Seat #3 is the button
Seat 1: Hero ($5.06 in chips)
Seat 2: 6e117840 ($1.86 in chips)
Seat 3: 1120325c ($0.75 in chips)
Seat 4: 3989b5f1 ($4.14 in chips)
Seat 5: 68bed66e ($0.51 in chips)
Seat 6: aab27c0e ($1.77 in chips)
3989b5f1: posts small blind $0.01
68bed66e: posts big blind $0.02
*** HOLE CARDS ***
Dealt to Hero [Qh 8s]
Dealt to 6e117840 
Dealt to 1120325c 
Dealt to 3989b5f1 
Dealt to 68bed66e 
Dealt to aab27c0e 
aab27c0e: raises $0.04 to $0.06
Hero: folds
6e117840: folds
1120325c: folds
3989b5f1: folds
68bed66e: calls $0.04
*** FLOP *** [5s 7c 4d]
68bed66e: bets $0.07
aab27c0e: calls $0.07
*** TURN *** [5s 7c 4d] [3d]
68bed66e: checks
aab27c0e: checks
*** RIVER *** [5s 7c 4d 3d] [Tc]
68bed66e: bets $0.09
aab27c0e: calls $0.09
68bed66e: shows [Ks 5c] (Pair of Fives)
aab27c0e: shows [9d 9c] (Pair of Nines)
*** SHOWDOWN ***
aab27c0e collected $0.43 from pot
*** SUMMARY ***
Total pot $0.45 | Rake $0.02 | Jackpot $0 | Bingo $0 | Fortune $0 | Tax $0
Board [5s 7c 4d 3d Tc]
Seat 1: Hero folded before Flop (didn't bet)
Seat 2: 6e117840 folded before Flop (didn't bet)
Seat 3: 1120325c (button) folded before Flop (didn't bet)
Seat 4: 3989b5f1 (small blind) folded before Flop
Seat 5: 68bed66e (big blind) showed [Ks 5c] and lost with Pair of Fives
Seat 6: aab27c0e showed [9d 9c] and won ($0.43) with Pair of Nines


Poker Hand #HD50931380: Hold'em No Limit ($0.01/$0.02) - 2024/05/21 20:45:22
Table 'NLHYellow5' 6-max Seat #2 is the button
Seat 1: Hero ($5.06 in chips)
Seat 2: 6e117840 ($1.86 in chips)
Seat 3: 1120325c ($0.83 in chips)
Seat 4: 3989b5f1 ($4.16 in chips)
Seat 5: 68bed66e ($0.59 in chips)
Seat 6: aab27c0e ($1.6 in chips)
1120325c: posts small blind $0.01
3989b5f1: posts big blind $0.02
*** HOLE CARDS ***
Dealt to Hero [5s Qc]
Dealt to 6e117840 
Dealt to 1120325c 
Dealt to 3989b5f1 
Dealt to 68bed66e 
Dealt to aab27c0e 
68bed66e: calls $0.02
aab27c0e: raises $0.06 to $0.08
Hero: folds
6e117840: folds
1120325c: calls $0.07
3989b5f1: folds
68bed66e: calls $0.06
*** FLOP *** [2d 2s 5d]
1120325c: checks
68bed66e: checks
aab27c0e: bets $0.13
1120325c: folds
68bed66e: folds
Uncalled bet ($0.13) returned to aab27c0e
aab27c0e: shows [Ah Kd] (Pair of Twos)
*** SHOWDOWN ***
aab27c0e collected $0.25 from pot
*** SUMMARY ***
Total pot $0.26 | Rake $0.01 | Jackpot $0 | Bingo $0 | Fortune $0 | Tax $0
Board [2d 2s 5d]
Seat 1: Hero folded before Flop (didn't bet)
Seat 2: 6e117840 (button) folded before Flop (didn't bet)
Seat 3: 1120325c (small blind) folded on the Flop
Seat 4: 3989b5f1 (big blind) folded before Flop
Seat 5: 68bed66e folded on the Flop
Seat 6: aab27c0e showed [Ah Kd] and won ($0.25)


Poker Hand #HD50931356: Hold'em No Limit ($0.01/$0.02) - 2024/05/21 20:44:14
Table 'NLHYellow5' 6-max Seat #1 is the button
Seat 1: Hero ($5.06 in chips)
Seat 2: 6e117840 ($1.87 in chips)
Seat 3: 1120325c ($0.85 in chips)
Seat 4: 3989b5f1 ($4.21 in chips)
Seat 5: 68bed66e ($0.51 in chips)
Seat 6: aab27c0e ($1.6 in chips)
6e117840: posts small blind $0.01
1120325c: posts big blind $0.02
*** HOLE CARDS ***
Dealt to Hero [6s Qc]
Dealt to 6e117840 
Dealt to 1120325c 
Dealt to 3989b5f1 
Dealt to 68bed66e 
Dealt to aab27c0e 
3989b5f1: raises $0.03 to $0.05
68bed66e: calls $0.05
aab27c0e: folds
Hero: folds
6e117840: folds
1120325c: folds
*** FLOP *** [As Jh 4s]
3989b5f1: checks
68bed66e: checks
*** TURN *** [As Jh 4s] [9h]
3989b5f1: checks
68bed66e: bets $0.1
3989b5f1: folds
Uncalled bet ($0.1) returned to 68bed66e
*** SHOWDOWN ***
68bed66e collected $0.13 from pot
*** SUMMARY ***
Total pot $0.13 | Rake $0 | Jackpot $0 | Bingo $0 | Fortune $0 | Tax $0
Board [As Jh 4s 9h]
Seat 1: Hero (button) folded before Flop (didn't bet)
Seat 2: 6e117840 (small blind) folded before Flop
Seat 3: 1120325c (big blind) folded before Flop
Seat 4: 3989b5f1 folded on the Turn
Seat 5: 68bed66e won ($0.13)
Seat 6: aab27c0e folded before Flop (didn't bet)


Poker Hand #HD50931346: Hold'em No Limit ($0.01/$0.02) - 2024/05/21 20:43:41
Table 'NLHYellow5' 6-max Seat #6 is the button
Seat 1: Hero ($5.07 in chips)
Seat 2: 6e117840 ($1.89 in chips)
Seat 3: 1120325c ($0.85 in chips)
Seat 4: 3989b5f1 ($4.26 in chips)
Seat 5: 68bed66e ($0.43 in chips)
Seat 6: aab27c0e ($1.6 in chips)
Hero: posts small blind $0.01
6e117840: posts big blind $0.02
*** HOLE CARDS ***
Dealt to Hero [6c 9s]
Dealt to 6e117840 
Dealt to 1120325c 
Dealt to 3989b5f1 
Dealt to 68bed66e 
Dealt to aab27c0e 
1120325c: folds
3989b5f1: raises $0.03 to $0.05
68bed66e: calls $0.05
aab27c0e: folds
Hero: folds
6e117840: folds
*** FLOP *** [Ks 9c 3c]
3989b5f1: checks
68bed66e: checks
*** TURN *** [Ks 9c 3c] [9h]
3989b5f1: checks
68bed66e: bets $0.07
3989b5f1: folds
Uncalled bet ($0.07) returned to 68bed66e
*** SHOWDOWN ***
68bed66e collected $0.13 from pot
*** SUMMARY ***
Total pot $0.13 | Rake $0 | Jackpot $0 | Bingo $0 | Fortune $0 | Tax $0
Board [Ks 9c 3c 9h]
Seat 1: Hero (small blind) folded before Flop
Seat 2: 6e117840 (big blind) folded before Flop
Seat 3: 1120325c folded before Flop (didn't bet)
Seat 4: 3989b5f1 folded on the Turn
Seat 5: 68bed66e won ($0.13)
Seat 6: aab27c0e (button) folded before Flop (didn't bet)


Poker Hand #HD50931322: Hold'em No Limit ($0.01/$0.02) - 2024/05/21 20:42:38
Table 'NLHYellow5' 6-max Seat #5 is the button
Seat 1: Hero ($5.09 in chips)
Seat 2: 6e117840 ($1.97 in chips)
Seat 3: 1120325c ($0.85 in chips)
Seat 4: 3989b5f1 ($4.16 in chips)
Seat 5: 68bed66e ($0.43 in chips)
Seat 6: aab27c0e ($1.61 in chips)
aab27c0e: posts small blind $0.01
Hero: posts big blind $0.02
*** HOLE CARDS ***
Dealt to Hero [Ks 9h]
Dealt to 6e117840 
Dealt to 1120325c 
Dealt to 3989b5f1 
Dealt to 68bed66e 
Dealt to aab27c0e 
6e117840: calls $0.02
1120325c: folds
3989b5f1: raises $0.06 to $0.08
68bed66e: folds
aab27c0e: folds
Hero: folds
6e117840: calls $0.06
*** FLOP *** [Kh 8c 2d]
6e117840: checks
3989b5f1: checks
*** TURN *** [Kh 8c 2d] [7c]
6e117840: checks
3989b5f1: bets $0.1
6e117840: folds
Uncalled bet ($0.1) returned to 3989b5f1
*** SHOWDOWN ***
3989b5f1 collected $0.18 from pot
*** SUMMARY ***
Total pot $0.19 | Rake $0.01 | Jackpot $0 | Bingo $0 | Fortune $0 | Tax $0
Board [Kh 8c 2d 7c]
Seat 1: Hero (big blind) folded before Flop
Seat 2: 6e117840 folded on the Turn
Seat 3: 1120325c folded before Flop (didn't bet)
Seat 4: 3989b5f1 won ($0.18)
Seat 5: 68bed66e (button) folded before Flop (didn't bet)
Seat 6: aab27c0e (small blind) folded before Flop


Poker Hand #HD50931314: Hold'em No Limit ($0.01/$0.02) - 2024/05/21 20:42:26
Table 'NLHYellow5' 6-max Seat #4 is the button
Seat 1: Hero ($5.06 in chips)
Seat 2: 6e117840 ($1.97 in chips)
Seat 3: 1120325c ($0.85 in chips)
Seat 4: 3989b5f1 ($4.16 in chips)
Seat 5: 68bed66e ($0.44 in chips)
Seat 6: aab27c0e ($1.63 in chips)
68bed66e: posts small blind $0.01
aab27c0e: posts big blind $0.02
*** HOLE CARDS ***
Dealt to Hero [7h As]
Dealt to 6e117840 
Dealt to 1120325c 
Dealt to 3989b5f1 
Dealt to 68bed66e 
Dealt to aab27c0e 
Hero: raises $0.03 to $0.05
6e117840: folds
1120325c: folds
3989b5f1: folds
68bed66e: folds
aab27c0e: folds
Uncalled bet ($0.03) returned to Hero
*** SHOWDOWN ***
Hero collected $0.05 from pot
*** SUMMARY ***
Total pot $0.05 | Rake $0 | Jackpot $0 | Bingo $0 | Fortune $0 | Tax $0
Seat 1: Hero collected ($0.05)
Seat 2: 6e117840 folded before Flop (didn't bet)
Seat 3: 1120325c folded before Flop (didn't bet)
Seat 4: 3989b5f1 (button) folded before Flop (didn't bet)
Seat 5: 68bed66e (small blind) folded before Flop
Seat 6: aab27c0e (big blind) folded before Flop


Poker Hand #HD50931306: Hold'em No Limit ($0.01/$0.02) - 2024/05/21 20:42:02
Table 'NLHYellow5' 6-max Seat #3 is the button
Seat 1: Hero ($5.11 in chips)
Seat 2: 6e117840 ($1.97 in chips)
Seat 3: 1120325c ($0.85 in chips)
Seat 4: 3989b5f1 ($4.17 in chips)
Seat 5: 68bed66e ($0.38 in chips)
Seat 6: aab27c0e ($1.63 in chips)
3989b5f1: posts small blind $0.01
68bed66e: posts big blind $0.02
*** HOLE CARDS ***
Dealt to Hero [9c Jc]
Dealt to 6e117840 
Dealt to 1120325c 
Dealt to 3989b5f1 
Dealt to 68bed66e 
Dealt to aab27c0e 
aab27c0e: folds
Hero: raises $0.03 to $0.05
6e117840: folds
1120325c: folds
3989b5f1: folds
68bed66e: calls $0.03
*** FLOP *** [6d 4h 7h]
68bed66e: bets $0.06
Hero: folds
Uncalled bet ($0.06) returned to 68bed66e
*** SHOWDOWN ***
68bed66e collected $0.11 from pot
*** SUMMARY ***
Total pot $0.11 | Rake $0 | Jackpot $0 | Bingo $0 | Fortune $0 | Tax $0
Board [6d 4h 7h]
Seat 1: Hero folded on the Flop
Seat 2: 6e117840 folded before Flop (didn't bet)
Seat 3: 1120325c (button) folded before Flop (didn't bet)
Seat 4: 3989b5f1 (small blind) folded before Flop
Seat 5: 68bed66e (big blind) won ($0.11)
Seat 6: aab27c0e folded before Flop (didn't bet)


Poker Hand #HD50931286: Hold'em No Limit ($0.01/$0.02) - 2024/05/21 20:41:25
Table 'NLHYellow5' 6-max Seat #2 is the button
Seat 1: Hero ($5.13 in chips)
Seat 2: 6e117840 ($1.97 in chips)
Seat 3: 1120325c ($0.86 in chips)
Seat 4: 3989b5f1 ($4.19 in chips)
Seat 5: 68bed66e ($0.33 in chips)
Seat 6: aab27c0e ($1.63 in chips)
1120325c: posts small blind $0.01
3989b5f1: posts big blind $0.02
*** HOLE CARDS ***
Dealt to Hero [7d 7c]
Dealt to 6e117840 
Dealt to 1120325c 
Dealt to 3989b5f1 
Dealt to 68bed66e 
Dealt to aab27c0e 
68bed66e: calls $0.02
aab27c0e: folds
Hero: calls $0.02
6e117840: folds
1120325c: folds
3989b5f1: checks
*** FLOP *** [Ks 4c Qc]
3989b5f1: checks
68bed66e: bets $0.06
Hero: folds
3989b5f1: folds
Uncalled bet ($0.06) returned to 68bed66e
*** SHOWDOWN ***
68bed66e collected $0.07 from pot
*** SUMMARY ***
Total pot $0.07 | Rake $0 | Jackpot $0 | Bingo $0 | Fortune $0 | Tax $0
Board [Ks 4c Qc]
Seat 1: Hero folded on the Flop
Seat 2: 6e117840 (button) folded before Flop (didn't bet)
Seat 3: 1120325c (small blind) folded before Flop
Seat 4: 3989b5f1 (big blind) folded on the Flop
Seat 5: 68bed66e won ($0.07)
Seat 6: aab27c0e folded before Flop (didn't bet)


Poker Hand #HD50931270: Hold'em No Limit ($0.01/$0.02) - 2024/05/21 20:40:55
Table 'NLHYellow5' 6-max Seat #1 is the button
Seat 1: Hero ($5.03 in chips)
Seat 2: 6e117840 ($1.98 in chips)
Seat 3: 1120325c ($0.88 in chips)
Seat 4: 3989b5f1 ($4.19 in chips)
Seat 5: 68bed66e ($0.41 in chips)
Seat 6: aab27c0e ($1.63 in chips)
6e117840: posts small blind $0.01
1120325c: posts big blind $0.02
*** HOLE CARDS ***
Dealt to Hero [9s Ah]
Dealt to 6e117840 
Dealt to 1120325c 
Dealt to 3989b5f1 
Dealt to 68bed66e 
Dealt to aab27c0e 
3989b5f1: folds
68bed66e: calls $0.02
aab27c0e: folds
Hero: raises $0.06 to $0.08
6e117840: folds
1120325c: folds
68bed66e: calls $0.06
*** FLOP *** [Qd 5h As]
68bed66e: checks
Hero: bets $0.07
68bed66e: folds
Uncalled bet ($0.07) returned to Hero
*** SHOWDOWN ***
Hero collected $0.18 from pot
*** SUMMARY ***
Total pot $0.19 | Rake $0.01 | Jackpot $0 | Bingo $0 | Fortune $0 | Tax $0
Board [Qd 5h As]
Seat 1: Hero (button) won ($0.18)
Seat 2: 6e117840 (small blind) folded before Flop
Seat 3: 1120325c (big blind) folded before Flop
Seat 4: 3989b5f1 folded before Flop (didn't bet)
Seat 5: 68bed66e folded on the Flop
Seat 6: aab27c0e folded before Flop (didn't bet)


Poker Hand #HD50931263: Hold'em No Limit ($0.01/$0.02) - 2024/05/21 20:40:38
Table 'NLHYellow5' 6-max Seat #6 is the button
Seat 1: Hero ($5.04 in chips)
Seat 2: 6e117840 ($2 in chips)
Seat 3: 1120325c ($0.88 in chips)
Seat 4: 3989b5f1 ($4.19 in chips)
Seat 5: 68bed66e ($0.41 in chips)
Seat 6: aab27c0e ($1.6 in chips)
Hero: posts small blind $0.01
6e117840: posts big blind $0.02
*** HOLE CARDS ***
Dealt to Hero [3h 7d]
Dealt to 6e117840 
Dealt to 1120325c 
Dealt to 3989b5f1 
Dealt to 68bed66e 
Dealt to aab27c0e 
1120325c: folds
3989b5f1: folds
68bed66e: folds
aab27c0e: raises $0.06 to $0.08
Hero: folds
6e117840: folds
Uncalled bet ($0.06) returned to aab27c0e
*** SHOWDOWN ***
aab27c0e collected $0.05 from pot
*** SUMMARY ***
Total pot $0.05 | Rake $0 | Jackpot $0 | Bingo $0 | Fortune $0 | Tax $0
Seat 1: Hero (small blind) folded before Flop
Seat 2: 6e117840 (big blind) folded before Flop
Seat 3: 1120325c folded before Flop (didn't bet)
Seat 4: 3989b5f1 folded before Flop (didn't bet)
Seat 5: 68bed66e folded before Flop (didn't bet)
Seat 6: aab27c0e (button) collected ($0.05)


Poker Hand #HD50931259: Hold'em No Limit ($0.01/$0.02) - 2024/05/21 20:40:26
Table 'NLHYellow5' 6-max Seat #5 is the button
Seat 1: Hero ($5.06 in chips)
Seat 2: 6e117840 ($2 in chips)
Seat 3: 1120325c ($0.88 in chips)
Seat 4: 3989b5f1 ($4.19 in chips)
Seat 5: 68bed66e ($0.38 in chips)
Seat 6: aab27c0e ($1.61 in chips)
aab27c0e: posts small blind $0.01
Hero: posts big blind $0.02
*** HOLE CARDS ***
Dealt to Hero [Kd 4h]
Dealt to 6e117840 
Dealt to 1120325c 
Dealt to 3989b5f1 
Dealt to 68bed66e 
Dealt to aab27c0e 
6e117840: folds
1120325c: folds
3989b5f1: folds
68bed66e: raises $0.06 to $0.08
aab27c0e: folds
Hero: folds
Uncalled bet ($0.06) returned to 68bed66e
*** SHOWDOWN ***
68bed66e collected $0.05 from pot
*** SUMMARY ***
Total pot $0.05 | Rake $0 | Jackpot $0 | Bingo $0 | Fortune $0 | Tax $0
Seat 1: Hero (big blind) folded before Flop
Seat 2: 6e117840 folded before Flop (didn't bet)
Seat 3: 1120325c folded before Flop (didn't bet)
Seat 4: 3989b5f1 folded before Flop (didn't bet)
Seat 5: 68bed66e (button) collected ($0.05)
Seat 6: aab27c0e (small blind) folded before Flop


Poker Hand #HD50931252: Hold'em No Limit ($0.01/$0.02) - 2024/05/21 20:40:07
Table 'NLHYellow5' 6-max Seat #4 is the button
Seat 1: Hero ($5.06 in chips)
Seat 2: 6e117840 ($2 in chips)
Seat 3: 1120325c ($0.88 in chips)
Seat 4: 3989b5f1 ($4.19 in chips)
Seat 5: 68bed66e ($0.4 in chips)
Seat 6: aab27c0e ($1.59 in chips)
68bed66e: posts small blind $0.01
aab27c0e: posts big blind $0.02
*** HOLE CARDS ***
Dealt to Hero [2c Qs]
Dealt to 6e117840 
Dealt to 1120325c 
Dealt to 3989b5f1 
Dealt to 68bed66e 
Dealt to aab27c0e 
Hero: folds
6e117840: folds
1120325c: folds
3989b5f1: folds
68bed66e: calls $0.01
aab27c0e: raises $0.04 to $0.06
68bed66e: folds
Uncalled bet ($0.04) returned to aab27c0e
*** SHOWDOWN ***
aab27c0e collected $0.04 from pot
*** SUMMARY ***
Total pot $0.04 | Rake $0 | Jackpot $0 | Bingo $0 | Fortune $0 | Tax $0
Seat 1: Hero folded before Flop (didn't bet)
Seat 2: 6e117840 folded before Flop (didn't bet)
Seat 3: 1120325c folded before Flop (didn't bet)
Seat 4: 3989b5f1 (button) folded before Flop (didn't bet)
Seat 5: 68bed66e (small blind) folded before Flop
Seat 6: aab27c0e (big blind) collected ($0.04)


Poker Hand #HD50931245: Hold'em No Limit ($0.01/$0.02) - 2024/05/21 20:39:57
Table 'NLHYellow5' 6-max Seat #3 is the button
Seat 1: Hero ($5.06 in chips)
Seat 2: 6e117840 ($2 in chips)
Seat 3: 1120325c ($0.88 in chips)
Seat 4: 3989b5f1 ($4.2 in chips)
Seat 5: 68bed66e ($0.39 in chips)
Seat 6: aab27c0e ($1.59 in chips)
3989b5f1: posts small blind $0.01
68bed66e: posts big blind $0.02
*** HOLE CARDS ***
Dealt to Hero [4h Ac]
Dealt to 6e117840 
Dealt to 1120325c 
Dealt to 3989b5f1 
Dealt to 68bed66e 
Dealt to aab27c0e 
aab27c0e: folds
Hero: folds
6e117840: folds
1120325c: folds
3989b5f1: folds
Uncalled bet ($0.01) returned to 68bed66e
*** SHOWDOWN ***
68bed66e collected $0.02 from pot
*** SUMMARY ***
Total pot $0.02 | Rake $0 | Jackpot $0 | Bingo $0 | Fortune $0 | Tax $0
Seat 1: Hero folded before Flop (didn't bet)
Seat 2: 6e117840 folded before Flop (didn't bet)
Seat 3: 1120325c (button) folded before Flop (didn't bet)
Seat 4: 3989b5f1 (small blind) folded before Flop
Seat 5: 68bed66e (big blind) collected ($0.02)
Seat 6: aab27c0e folded before Flop (didn't bet)


Poker Hand #HD50931219: Hold'em No Limit ($0.01/$0.02) - 2024/05/21 20:39:01
Table 'NLHYellow5' 6-max Seat #2 is the button
Seat 1: Hero ($4.82 in chips)
Seat 2: 6e117840 ($2 in chips)
Seat 3: 1120325c ($0.89 in chips)
Seat 4: 3989b5f1 ($4.22 in chips)
Seat 5: 68bed66e ($0.56 in chips)
Seat 6: aab27c0e ($1.65 in chips)
1120325c: posts small blind $0.01
3989b5f1: posts big blind $0.02
*** HOLE CARDS ***
Dealt to Hero [6d 5d]
Dealt to 6e117840 
Dealt to 1120325c 
Dealt to 3989b5f1 
Dealt to 68bed66e 
Dealt to aab27c0e 
68bed66e: calls $0.02
aab27c0e: raises $0.04 to $0.06
Hero: calls $0.06
6e117840: folds
1120325c: folds
3989b5f1: folds
68bed66e: calls $0.04
*** FLOP *** [8s 4s 6c]
68bed66e: checks
aab27c0e: checks
Hero: bets $0.11
68bed66e: calls $0.11
aab27c0e: folds
*** TURN *** [8s 4s 6c] [Ad]
68bed66e: checks
Hero: checks
*** RIVER *** [8s 4s 6c Ad] [Kh]
68bed66e: checks
Hero: checks
68bed66e: shows [9s Js] (Ace-High)
Hero: shows [6d 5d] (Pair of Sixes)
*** SHOWDOWN ***
Hero collected $0.41 from pot
*** SUMMARY ***
Total pot $0.43 | Rake $0.02 | Jackpot $0 | Bingo $0 | Fortune $0 | Tax $0
Board [8s 4s 6c Ad Kh]
Seat 1: Hero showed [6d 5d] and won ($0.41) with Pair of Sixes
Seat 2: 6e117840 (button) folded before Flop (didn't bet)
Seat 3: 1120325c (small blind) folded before Flop
Seat 4: 3989b5f1 (big blind) folded before Flop
Seat 5: 68bed66e showed [9s Js] and lost with Ace-High
Seat 6: aab27c0e folded on the Flop


Poker Hand #HD50931202: Hold'em No Limit ($0.01/$0.02) - 2024/05/21 20:38:20
Table 'NLHYellow5' 6-max Seat #1 is the button
Seat 1: Hero ($4.82 in chips)
Seat 2: 6e117840 ($1.18 in chips)
Seat 3: 1120325c ($1.04 in chips)
Seat 4: 3989b5f1 ($4.07 in chips)
Seat 5: 68bed66e ($0.56 in chips)
Seat 6: aab27c0e ($1.65 in chips)
6e117840: posts small blind $0.01
1120325c: posts big blind $0.02
*** HOLE CARDS ***
Dealt to Hero [4s Kc]
Dealt to 6e117840 
Dealt to 1120325c 
Dealt to 3989b5f1 
Dealt to 68bed66e 
Dealt to aab27c0e 
3989b5f1: raises $0.03 to $0.05
68bed66e: folds
aab27c0e: folds
Hero: folds
6e117840: folds
1120325c: calls $0.03
*** FLOP *** [4c 6d 5c]
1120325c: checks
3989b5f1: bets $0.04
1120325c: calls $0.04
*** TURN *** [4c 6d 5c] [9d]
1120325c: checks
3989b5f1: checks
*** RIVER *** [4c 6d 5c 9d] [Qs]
1120325c: checks
3989b5f1: bets $0.06
1120325c: calls $0.06
3989b5f1: shows [6h Kh] (Pair of Sixes)
1120325c: shows [3d 3c] (Pair of Treys)
*** SHOWDOWN ***
3989b5f1 collected $0.3 from pot
*** SUMMARY ***
Total pot $0.31 | Rake $0.01 | Jackpot $0 | Bingo $0 | Fortune $0 | Tax $0
Board [4c 6d 5c 9d Qs]
Seat 1: Hero (button) folded before Flop (didn't bet)
Seat 2: 6e117840 (small blind) folded before Flop
Seat 3: 1120325c (big blind) showed [3d 3c] and lost with Pair of Treys
Seat 4: 3989b5f1 showed [6h Kh] and won ($0.3) with Pair of Sixes
Seat 5: 68bed66e folded before Flop (didn't bet)
Seat 6: aab27c0e folded before Flop (didn't bet)


Poker Hand #HD50931189: Hold'em No Limit ($0.01/$0.02) - 2024/05/21 20:37:58
Table 'NLHYellow5' 6-max Seat #6 is the button
Seat 1: Hero ($4.72 in chips)
Seat 2: 6e117840 ($1.2 in chips)
Seat 4: 3989b5f1 ($4.07 in chips)
Seat 5: 68bed66e ($0.64 in chips)
Seat 6: aab27c0e ($1.65 in chips)
Hero: posts small blind $0.01
6e117840: posts big blind $0.02
*** HOLE CARDS ***
Dealt to Hero [9s As]
Dealt to 6e117840 
Dealt to 3989b5f1 
Dealt to 68bed66e 
Dealt to aab27c0e 
3989b5f1: folds
68bed66e: calls $0.02
aab27c0e: folds
Hero: raises $0.06 to $0.08
6e117840: folds
68bed66e: calls $0.06
*** FLOP *** [2c 2s Ah]
Hero: bets $0.09
68bed66e: folds
Uncalled bet ($0.09) returned to Hero
*** SHOWDOWN ***
Hero collected $0.18 from pot
*** SUMMARY ***
Total pot $0.18 | Rake $0 | Jackpot $0 | Bingo $0 | Fortune $0 | Tax $0
Board [2c 2s Ah]
Seat 1: Hero (small blind) won ($0.18)
Seat 2: 6e117840 (big blind) folded before Flop
Seat 4: 3989b5f1 folded before Flop (didn't bet)
Seat 5: 68bed66e folded on the Flop
Seat 6: aab27c0e (button) folded before Flop (didn't bet)


Poker Hand #HD50931157: Hold'em No Limit ($0.01/$0.02) - 2024/05/21 20:37:09
Table 'NLHYellow5' 6-max Seat #5 is the button
Seat 1: Hero ($4.82 in chips)
Seat 2: 6e117840 ($1.2 in chips)
Seat 4: 3989b5f1 ($3.77 in chips)
Seat 5: 68bed66e ($0.85 in chips)
Seat 6: aab27c0e ($1.66 in chips)
aab27c0e: posts small blind $0.01
Hero: posts big blind $0.02
*** HOLE CARDS ***
Dealt to Hero [Qc Kc]
Dealt to 6e117840 
Dealt to 3989b5f1 
Dealt to 68bed66e 
Dealt to aab27c0e 
6e117840: folds
3989b5f1: raises $0.03 to $0.05
68bed66e: raises $0.05 to $0.1
aab27c0e: folds
Hero: calls $0.08
3989b5f1: calls $0.05
*** FLOP *** [Td 8s 2d]
Hero: checks
3989b5f1: bets $0.11
68bed66e: calls $0.11
Hero: folds
*** TURN *** [Td 8s 2d] [5c]
3989b5f1: bets $0.4
68bed66e: folds
Uncalled bet ($0.4) returned to 3989b5f1
*** SHOWDOWN ***
3989b5f1 collected $0.51 from pot
*** SUMMARY ***
Total pot $0.53 | Rake $0.02 | Jackpot $0 | Bingo $0 | Fortune $0 | Tax $0
Board [Td 8s 2d 5c]
Seat 1: Hero (big blind) folded on the Flop
Seat 2: 6e117840 folded before Flop (didn't bet)
Seat 4: 3989b5f1 won ($0.51)
Seat 5: 68bed66e (button) folded on the Turn
Seat 6: aab27c0e (small blind) folded before Flop


Poker Hand #HD50931144: Hold'em No Limit ($0.01/$0.02) - 2024/05/21 20:36:42
Table 'NLHYellow5' 6-max Seat #4 is the button
Seat 1: Hero ($4.82 in chips)
Seat 2: 6e117840 ($1.2 in chips)
Seat 4: 3989b5f1 ($3.82 in chips)
Seat 5: 68bed66e ($0.86 in chips)
Seat 6: aab27c0e ($1.6 in chips)
68bed66e: posts small blind $0.01
aab27c0e: posts big blind $0.02
*** HOLE CARDS ***
Dealt to Hero [Qd 3d]
Dealt to 6e117840 
Dealt to 3989b5f1 
Dealt to 68bed66e 
Dealt to aab27c0e 
Hero: folds
6e117840: folds
3989b5f1: raises $0.03 to $0.05
68bed66e: folds
aab27c0e: raises $0.15 to $0.2
3989b5f1: folds
Uncalled bet ($0.15) returned to aab27c0e
*** SHOWDOWN ***
aab27c0e collected $0.11 from pot
*** SUMMARY ***
Total pot $0.11 | Rake $0 | Jackpot $0 | Bingo $0 | Fortune $0 | Tax $0
Seat 1: Hero folded before Flop (didn't bet)
Seat 2: 6e117840 folded before Flop (didn't bet)
Seat 4: 3989b5f1 (button) folded before Flop
Seat 5: 68bed66e (small blind) folded before Flop
Seat 6: aab27c0e (big blind) collected ($0.11)


Poker Hand #HD50931127: Hold'em No Limit ($0.01/$0.02) - 2024/05/21 20:35:59
Table 'NLHYellow5' 6-max Seat #2 is the button
Seat 1: Hero ($4.82 in chips)
Seat 2: 6e117840 ($1.2 in chips)
Seat 3: edc59043 ($5.22 in chips)
Seat 4: 3989b5f1 ($3.67 in chips)
Seat 5: 68bed66e ($1.01 in chips)
edc59043: posts small blind $0.01
3989b5f1: posts big blind $0.02
*** HOLE CARDS ***
Dealt to Hero [9s Qh]
Dealt to 6e117840 
Dealt to edc59043 
Dealt to 3989b5f1 
Dealt to 68bed66e 
68bed66e: calls $0.02
Hero: folds
6e117840: folds
edc59043: folds
3989b5f1: checks
*** FLOP *** [Ad 8h Qc]
3989b5f1: checks
68bed66e: bets $0.05
3989b5f1: calls $0.05
*** TURN *** [Ad 8h Qc] [4s]
3989b5f1: checks
68bed66e: checks
*** RIVER *** [Ad 8h Qc 4s] [2c]
3989b5f1: checks
68bed66e: bets $0.08
3989b5f1: raises $0.22 to $0.3
68bed66e: folds
Uncalled bet ($0.22) returned to 3989b5f1
*** SHOWDOWN ***
3989b5f1 collected $0.3 from pot
*** SUMMARY ***
Total pot $0.31 | Rake $0.01 | Jackpot $0 | Bingo $0 | Fortune $0 | Tax $0
Board [Ad 8h Qc 4s 2c]
Seat 1: Hero folded before Flop (didn't bet)
Seat 2: 6e117840 (button) folded before Flop (didn't bet)
Seat 3: edc59043 (small blind) folded before Flop
Seat 4: 3989b5f1 (big blind) won ($0.3)
Seat 5: 68bed66e folded on the River


Poker Hand #HD50931112: Hold'em No Limit ($0.01/$0.02) - 2024/05/21 20:35:31
Table 'NLHYellow5' 6-max Seat #1 is the button
Seat 1: Hero ($4.87 in chips)
Seat 2: 6e117840 ($1.21 in chips)
Seat 3: edc59043 ($5.11 in chips)
Seat 4: 3989b5f1 ($3.72 in chips)
Seat 5: 68bed66e ($1.01 in chips)
6e117840: posts small blind $0.01
edc59043: posts big blind $0.02
*** HOLE CARDS ***
Dealt to Hero [3h Ah]
Dealt to 6e117840 
Dealt to edc59043 
Dealt to 3989b5f1 
Dealt to 68bed66e 
3989b5f1: raises $0.03 to $0.05
68bed66e: folds
Hero: calls $0.05
6e117840: folds
edc59043: raises $0.16 to $0.21
3989b5f1: folds
Hero: folds
Uncalled bet ($0.16) returned to edc59043
*** SHOWDOWN ***
edc59043 collected $0.16 from pot
*** SUMMARY ***
Total pot $0.16 | Rake $0 | Jackpot $0 | Bingo $0 | Fortune $0 | Tax $0
Seat 1: Hero (button) folded before Flop
Seat 2: 6e117840 (small blind) folded before Flop
Seat 3: edc59043 (big blind) collected ($0.16)
Seat 4: 3989b5f1 folded before Flop
Seat 5: 68bed66e folded before Flop (didn't bet)


Poker Hand #HD50931069: Hold'em No Limit ($0.01/$0.02) - 2024/05/21 20:34:12
Table 'NLHYellow5' 6-max Seat #5 is the button
Seat 1: Hero ($4.88 in chips)
Seat 2: 6e117840 ($1.29 in chips)
Seat 3: edc59043 ($4.36 in chips)
Seat 4: 3989b5f1 ($4.48 in chips)
Seat 5: 68bed66e ($1.01 in chips)
Hero: posts small blind $0.01
6e117840: posts big blind $0.02
*** HOLE CARDS ***
Dealt to Hero [9d 4s]
Dealt to 6e117840 
Dealt to edc59043 
Dealt to 3989b5f1 
Dealt to 68bed66e 
edc59043: calls $0.02
3989b5f1: raises $0.06 to $0.08
68bed66e: folds
Hero: folds
6e117840: calls $0.06
edc59043: calls $0.06
*** FLOP *** [Ts Jc Qd]
6e117840: checks
edc59043: checks
3989b5f1: bets $0.09
6e117840: folds
edc59043: calls $0.09
*** TURN *** [Ts Jc Qd] [2c]
edc59043: checks
3989b5f1: bets $0.15
edc59043: calls $0.15
*** RIVER *** [Ts Jc Qd 2c] [Qh]
edc59043: checks
3989b5f1: bets $0.44
edc59043: calls $0.44
3989b5f1: shows [Kd 7d] (Pair of Queens)
edc59043: shows [8h 9h] (Queens-High Straight)
*** SHOWDOWN ***
edc59043 collected $1.51 from pot
*** SUMMARY ***
Total pot $1.61 | Rake $0.08 | Jackpot $0.02 | Bingo $0 | Fortune $0 | Tax $0
Board [Ts Jc Qd 2c Qh]
Seat 1: Hero (small blind) folded before Flop
Seat 2: 6e117840 (big blind) folded on the Flop
Seat 3: edc59043 showed [8h 9h] and won ($1.51) with Queens-High Straight
Seat 4: 3989b5f1 showed [Kd 7d] and lost with Pair of Queens
Seat 5: 68bed66e (button) folded before Flop (didn't bet)


Poker Hand #HD50931062: Hold'em No Limit ($0.01/$0.02) - 2024/05/21 20:33:59
Table 'NLHYellow5' 6-max Seat #4 is the button
Seat 1: Hero ($4.87 in chips)
Seat 2: 6e117840 ($1.29 in chips)
Seat 3: edc59043 ($4.36 in chips)
Seat 4: 3989b5f1 ($4.48 in chips)
Seat 5: 68bed66e ($1.02 in chips)
68bed66e: posts small blind $0.01
Hero: posts big blind $0.02
*** HOLE CARDS ***
Dealt to Hero [8h 3c]
Dealt to 6e117840 
Dealt to edc59043 
Dealt to 3989b5f1 
Dealt to 68bed66e 
6e117840: folds
edc59043: folds
3989b5f1: folds
68bed66e: folds
Uncalled bet ($0.01) returned to Hero
*** SHOWDOWN ***
Hero collected $0.02 from pot
*** SUMMARY ***
Total pot $0.02 | Rake $0 | Jackpot $0 | Bingo $0 | Fortune $0 | Tax $0
Seat 1: Hero (big blind) collected ($0.02)
Seat 2: 6e117840 folded before Flop (didn't bet)
Seat 3: edc59043 folded before Flop (didn't bet)
Seat 4: 3989b5f1 (button) folded before Flop (didn't bet)
Seat 5: 68bed66e (small blind) folded before Flop


Poker Hand #HD50931046: Hold'em No Limit ($0.01/$0.02) - 2024/05/21 20:33:16
Table 'NLHYellow5' 6-max Seat #3 is the button
Seat 1: Hero ($4.87 in chips)
Seat 2: 6e117840 ($1.29 in chips)
Seat 3: edc59043 ($4.28 in chips)
Seat 4: 3989b5f1 ($4.52 in chips)
Seat 5: 68bed66e ($1.06 in chips)
3989b5f1: posts small blind $0.01
68bed66e: posts big blind $0.02
*** HOLE CARDS ***
Dealt to Hero [5c 4s]
Dealt to 6e117840 
Dealt to edc59043 
Dealt to 3989b5f1 
Dealt to 68bed66e 
Hero: folds
6e117840: folds
edc59043: raises $0.02 to $0.04
3989b5f1: calls $0.03
68bed66e: calls $0.02
*** FLOP *** [2d 8c Jc]
3989b5f1: checks
68bed66e: checks
edc59043: checks
*** TURN *** [2d 8c Jc] [4h]
3989b5f1: checks
68bed66e: checks
edc59043: bets $0.06
3989b5f1: folds
68bed66e: folds
Uncalled bet ($0.06) returned to edc59043
*** SHOWDOWN ***
edc59043 collected $0.12 from pot
*** SUMMARY ***
Total pot $0.12 | Rake $0 | Jackpot $0 | Bingo $0 | Fortune $0 | Tax $0
Board [2d 8c Jc 4h]
Seat 1: Hero folded before Flop (didn't bet)
Seat 2: 6e117840 folded before Flop (didn't bet)
Seat 3: edc59043 (button) won ($0.12)
Seat 4: 3989b5f1 (small blind) folded on the Turn
Seat 5: 68bed66e (big blind) folded on the Turn


Poker Hand #HD50931036: Hold'em No Limit ($0.01/$0.02) - 2024/05/21 20:32:54
Table 'NLHYellow5' 6-max Seat #2 is the button
Seat 1: Hero ($4.87 in chips)
Seat 2: 6e117840 ($1.29 in chips)
Seat 3: edc59043 ($4.26 in chips)
Seat 4: 3989b5f1 ($4.54 in chips)
Seat 5: 68bed66e ($1.06 in chips)
edc59043: posts small blind $0.01
3989b5f1: posts big blind $0.02
*** HOLE CARDS ***
Dealt to Hero [Th Ks]
Dealt to 6e117840 
Dealt to edc59043 
Dealt to 3989b5f1 
Dealt to 68bed66e 
68bed66e: folds
Hero: folds
6e117840: folds
edc59043: calls $0.01
3989b5f1: checks
*** FLOP *** [4c 9s 2s]
edc59043: checks
3989b5f1: checks
*** TURN *** [4c 9s 2s] [3c]
edc59043: bets $0.04
3989b5f1: folds
Uncalled bet ($0.04) returned to edc59043
*** SHOWDOWN ***
edc59043 collected $0.04 from pot
*** SUMMARY ***
Total pot $0.04 | Rake $0 | Jackpot $0 | Bingo $0 | Fortune $0 | Tax $0
Board [4c 9s 2s 3c]
Seat 1: Hero folded before Flop (didn't bet)
Seat 2: 6e117840 (button) folded before Flop (didn't bet)
Seat 3: edc59043 (small blind) won ($0.04)
Seat 4: 3989b5f1 (big blind) folded on the Turn
Seat 5: 68bed66e folded before Flop (didn't bet)


Poker Hand #HD50931023: Hold'em No Limit ($0.01/$0.02) - 2024/05/21 20:32:20
Table 'NLHYellow5' 6-max Seat #1 is the button
Seat 1: Hero ($4.87 in chips)
Seat 2: 6e117840 ($1.3 in chips)
Seat 3: edc59043 ($4.43 in chips)
Seat 4: 3989b5f1 ($4.54 in chips)
Seat 5: 68bed66e ($0.89 in chips)
6e117840: posts small blind $0.01
edc59043: posts big blind $0.02
*** HOLE CARDS ***
Dealt to Hero [5s 3c]
Dealt to 6e117840 
Dealt to edc59043 
Dealt to 3989b5f1 
Dealt to 68bed66e 
3989b5f1: folds
68bed66e: raises $0.06 to $0.08
Hero: folds
6e117840: folds
edc59043: calls $0.06
*** FLOP *** [4s 7d 7c]
edc59043: checks
68bed66e: bets $0.09
edc59043: calls $0.09
*** TURN *** [4s 7d 7c] [6d]
edc59043: checks
68bed66e: bets $0.18
edc59043: folds
Uncalled bet ($0.18) returned to 68bed66e
*** SHOWDOWN ***
68bed66e collected $0.34 from pot
*** SUMMARY ***
Total pot $0.35 | Rake $0.01 | Jackpot $0 | Bingo $0 | Fortune $0 | Tax $0
Board [4s 7d 7c 6d]
Seat 1: Hero (button) folded before Flop (didn't bet)
Seat 2: 6e117840 (small blind) folded before Flop
Seat 3: edc59043 (big blind) folded on the Turn
Seat 4: 3989b5f1 folded before Flop (didn't bet)
Seat 5: 68bed66e won ($0.34)


Poker Hand #HD50931010: Hold'em No Limit ($0.01/$0.02) - 2024/05/21 20:31:49
Table 'NLHYellow5' 6-max Seat #5 is the button
Seat 1: Hero ($4.7 in chips)
Seat 2: 6e117840 ($1.32 in chips)
Seat 3: edc59043 ($4.59 in chips)
Seat 4: 3989b5f1 ($4.54 in chips)
Seat 5: 68bed66e ($0.89 in chips)
Hero: posts small blind $0.01
6e117840: posts big blind $0.02
*** HOLE CARDS ***
Dealt to Hero [Jd As]
Dealt to 6e117840 
Dealt to edc59043 
Dealt to 3989b5f1 
Dealt to 68bed66e 
edc59043: raises $0.02 to $0.04
3989b5f1: folds
68bed66e: folds
Hero: raises $0.12 to $0.16
6e117840: folds
edc59043: calls $0.12
*** FLOP *** [9s Ks 9d]
Hero: bets $0.12
edc59043: folds
Uncalled bet ($0.12) returned to Hero
*** SHOWDOWN ***
Hero collected $0.33 from pot
*** SUMMARY ***
Total pot $0.34 | Rake $0.01 | Jackpot $0 | Bingo $0 | Fortune $0 | Tax $0
Board [9s Ks 9d]
Seat 1: Hero (small blind) won ($0.33)
Seat 2: 6e117840 (big blind) folded before Flop
Seat 3: edc59043 folded on the Flop
Seat 4: 3989b5f1 folded before Flop (didn't bet)
Seat 5: 68bed66e (button) folded before Flop (didn't bet)


Poker Hand #HD50930993: Hold'em No Limit ($0.01/$0.02) - 2024/05/21 20:31:04
Table 'NLHYellow5' 6-max Seat #4 is the button
Seat 1: Hero ($4.72 in chips)
Seat 2: 6e117840 ($1.1 in chips)
Seat 3: edc59043 ($4.63 in chips)
Seat 4: 3989b5f1 ($4.54 in chips)
Seat 5: 68bed66e ($1.07 in chips)
68bed66e: posts small blind $0.01
Hero: posts big blind $0.02
*** HOLE CARDS ***
Dealt to Hero [Js 3d]
Dealt to 6e117840 
Dealt to edc59043 
Dealt to 3989b5f1 
Dealt to 68bed66e 
6e117840: raises $0.02 to $0.04
edc59043: calls $0.04
3989b5f1: folds
68bed66e: calls $0.03
Hero: folds
*** FLOP *** [Jh 4h 9c]
68bed66e: checks
6e117840: checks
edc59043: checks
*** TURN *** [Jh 4h 9c] [Ts]
68bed66e: checks
6e117840: checks
edc59043: checks
*** RIVER *** [Jh 4h 9c Ts] [Kh]
68bed66e: bets $0.14
6e117840: calls $0.14
edc59043: folds
68bed66e: shows [2h Qs] (Kings-High Straight)
6e117840: shows [Th 8h] (King High Flush)
*** SHOWDOWN ***
6e117840 collected $0.4 from pot
*** SUMMARY ***
Total pot $0.42 | Rake $0.02 | Jackpot $0 | Bingo $0 | Fortune $0 | Tax $0
Board [Jh 4h 9c Ts Kh]
Seat 1: Hero (big blind) folded before Flop
Seat 2: 6e117840 showed [Th 8h] and won ($0.4) with King High Flush
Seat 3: edc59043 folded on the River
Seat 4: 3989b5f1 (button) folded before Flop (didn't bet)
Seat 5: 68bed66e (small blind) showed [2h Qs] and lost with Kings-High Straight


Poker Hand #HD50930956: Hold'em No Limit ($0.01/$0.02) - 2024/05/21 20:29:57
Table 'NLHYellow5' 6-max Seat #3 is the button
Seat 1: Hero ($4.72 in chips)
Seat 2: 6e117840 ($1.14 in chips)
Seat 3: edc59043 ($4.33 in chips)
Seat 4: 3989b5f1 ($4.55 in chips)
Seat 5: 68bed66e ($1.37 in chips)
3989b5f1: posts small blind $0.01
68bed66e: posts big blind $0.02
*** HOLE CARDS ***
Dealt to Hero [7c 4d]
Dealt to 6e117840 
Dealt to edc59043 
Dealt to 3989b5f1 
Dealt to 68bed66e 
Hero: folds
6e117840: raises $0.02 to $0.04
edc59043: calls $0.04
3989b5f1: folds
68bed66e: calls $0.02
*** FLOP *** [Td 9h 2c]
68bed66e: bets $0.13
6e117840: folds
edc59043: calls $0.13
*** TURN *** [Td 9h 2c] [Kh]
68bed66e: checks
edc59043: checks
*** RIVER *** [Td 9h 2c Kh] [Qh]
68bed66e: bets $0.13
edc59043: raises $0.33 to $0.46
68bed66e: folds
Uncalled bet ($0.33) returned to edc59043
*** SHOWDOWN ***
edc59043 collected $0.6 from pot
*** SUMMARY ***
Total pot $0.65 | Rake $0.03 | Jackpot $0.02 | Bingo $0 | Fortune $0 | Tax $0
Board [Td 9h 2c Kh Qh]
Seat 1: Hero folded before Flop (didn't bet)
Seat 2: 6e117840 folded on the Flop
Seat 3: edc59043 (button) won ($0.6)
Seat 4: 3989b5f1 (small blind) folded before Flop
Seat 5: 68bed66e (big blind) folded on the River


Poker Hand #HD50930951: Hold'em No Limit ($0.01/$0.02) - 2024/05/21 20:29:42
Table 'NLHYellow5' 6-max Seat #2 is the button
Seat 1: Hero ($4.72 in chips)
Seat 2: 6e117840 ($1.14 in chips)
Seat 3: edc59043 ($4.31 in chips)
Seat 4: 3989b5f1 ($4.57 in chips)
Seat 5: 68bed66e ($1.37 in chips)
edc59043: posts small blind $0.01
3989b5f1: posts big blind $0.02
*** HOLE CARDS ***
Dealt to Hero [2c 3s]
Dealt to 6e117840 
Dealt to edc59043 
Dealt to 3989b5f1 
Dealt to 68bed66e 
68bed66e: folds
Hero: folds
6e117840: folds
edc59043: raises $0.04 to $0.06
3989b5f1: folds
Uncalled bet ($0.04) returned to edc59043
*** SHOWDOWN ***
edc59043 collected $0.04 from pot
*** SUMMARY ***
Total pot $0.04 | Rake $0 | Jackpot $0 | Bingo $0 | Fortune $0 | Tax $0
Seat 1: Hero folded before Flop (didn't bet)
Seat 2: 6e117840 (button) folded before Flop (didn't bet)
Seat 3: edc59043 (small blind) collected ($0.04)
Seat 4: 3989b5f1 (big blind) folded before Flop
Seat 5: 68bed66e folded before Flop (didn't bet)


Poker Hand #HD50930913: Hold'em No Limit ($0.01/$0.02) - 2024/05/21 20:28:21
Table 'NLHYellow5' 6-max Seat #1 is the button
Seat 1: Hero ($4.72 in chips)
Seat 2: 6e117840 ($1.16 in chips)
Seat 3: edc59043 ($3.74 in chips)
Seat 4: 3989b5f1 ($4.57 in chips)
Seat 5: 68bed66e ($1.45 in chips)
Seat 6: db58be20 ($0.54 in chips)
6e117840: posts small blind $0.01
edc59043: posts big blind $0.02
*** HOLE CARDS ***
Dealt to Hero [Js 8c]
Dealt to 6e117840 
Dealt to edc59043 
Dealt to 3989b5f1 
Dealt to 68bed66e 
Dealt to db58be20 
3989b5f1: folds
68bed66e: calls $0.02
db58be20: calls $0.02
Hero: folds
6e117840: calls $0.01
edc59043: checks
*** FLOP *** [Qd 6h Jc]
6e117840: checks
edc59043: checks
68bed66e: checks
db58be20: bets $0.06
6e117840: folds
edc59043: calls $0.06
68bed66e: calls $0.06
*** TURN *** [Qd 6h Jc] [6d]
edc59043: checks
68bed66e: checks
db58be20: bets $0.2
edc59043: raises $0.33 to $0.53
68bed66e: folds
db58be20: calls $0.26 and is all-in
Uncalled bet ($0.07) returned to edc59043
edc59043: shows [Kd 6s] (Three Sixes)
db58be20: shows [Kh Qc] (Pair of Queens and Pair of Sixes)
*** RIVER *** [Qd 6h Jc 6d] [Ts]
*** SHOWDOWN ***
edc59043 collected $1.11 from pot
*** SUMMARY ***
Total pot $1.18 | Rake $0.05 | Jackpot $0.02 | Bingo $0 | Fortune $0 | Tax $0
Board [Qd 6h Jc 6d Ts]
Seat 1: Hero (button) folded before Flop (didn't bet)
Seat 2: 6e117840 (small blind) folded on the Flop
Seat 3: edc59043 (big blind) showed [Kd 6s] and won ($1.11) with Three Sixes
Seat 4: 3989b5f1 folded before Flop (didn't bet)
Seat 5: 68bed66e folded on the Turn
Seat 6: db58be20 showed [Kh Qc] and lost with Pair of Queens and Pair of Sixes


Poker Hand #HD50930892: Hold'em No Limit ($0.01/$0.02) - 2024/05/21 20:27:16
Table 'NLHYellow5' 6-max Seat #6 is the button
Seat 1: Hero ($4.57 in chips)
Seat 2: 6e117840 ($1.18 in chips)
Seat 3: edc59043 ($3.74 in chips)
Seat 4: 3989b5f1 ($4.57 in chips)
Seat 5: 68bed66e ($1.59 in chips)
Seat 6: db58be20 ($0.54 in chips)
Hero: posts small blind $0.01
6e117840: posts big blind $0.02
*** HOLE CARDS ***
Dealt to Hero [Ah Ts]
Dealt to 6e117840 
Dealt to edc59043 
Dealt to 3989b5f1 
Dealt to 68bed66e 
Dealt to db58be20 
edc59043: folds
3989b5f1: folds
68bed66e: calls $0.02
db58be20: folds
Hero: raises $0.06 to $0.08
6e117840: folds
68bed66e: calls $0.06
*** FLOP *** [Qs Jh 3c]
Hero: bets $0.06
68bed66e: calls $0.06
*** TURN *** [Qs Jh 3c] [As]
Hero: bets $0.15
68bed66e: folds
Uncalled bet ($0.15) returned to Hero
*** SHOWDOWN ***
Hero collected $0.29 from pot
*** SUMMARY ***
Total pot $0.3 | Rake $0.01 | Jackpot $0 | Bingo $0 | Fortune $0 | Tax $0
Board [Qs Jh 3c As]
Seat 1: Hero (small blind) won ($0.29)
Seat 2: 6e117840 (big blind) folded before Flop
Seat 3: edc59043 folded before Flop (didn't bet)
Seat 4: 3989b5f1 folded before Flop (didn't bet)
Seat 5: 68bed66e folded on the Turn
Seat 6: db58be20 (button) folded before Flop (didn't bet)


Poker Hand #HD50930882: Hold'em No Limit ($0.01/$0.02) - 2024/05/21 20:26:54
Table 'NLHYellow5' 6-max Seat #5 is the button
Seat 1: Hero ($4.59 in chips)
Seat 2: 6e117840 ($1.18 in chips)
Seat 3: edc59043 ($3.74 in chips)
Seat 4: 3989b5f1 ($4.57 in chips)
Seat 5: 68bed66e ($1.56 in chips)
Seat 6: db58be20 ($0.55 in chips)
db58be20: posts small blind $0.01
Hero: posts big blind $0.02
*** HOLE CARDS ***
Dealt to Hero [Td 5s]
Dealt to 6e117840 
Dealt to edc59043 
Dealt to 3989b5f1 
Dealt to 68bed66e 
Dealt to db58be20 
6e117840: folds
edc59043: folds
3989b5f1: folds
68bed66e: calls $0.02
db58be20: folds
Hero: checks
*** FLOP *** [2h Qh 4h]
Hero: checks
68bed66e: bets $0.03
Hero: folds
Uncalled bet ($0.03) returned to 68bed66e
*** SHOWDOWN ***
68bed66e collected $0.05 from pot
*** SUMMARY ***
Total pot $0.05 | Rake $0 | Jackpot $0 | Bingo $0 | Fortune $0 | Tax $0
Board [2h Qh 4h]
Seat 1: Hero (big blind) folded on the Flop
Seat 2: 6e117840 folded before Flop (didn't bet)
Seat 3: edc59043 folded before Flop (didn't bet)
Seat 4: 3989b5f1 folded before Flop (didn't bet)
Seat 5: 68bed66e (button) won ($0.05)
Seat 6: db58be20 (small blind) folded before Flop


Poker Hand #HD50930855: Hold'em No Limit ($0.01/$0.02) - 2024/05/21 20:25:48
Table 'NLHYellow5' 6-max Seat #4 is the button
Seat 1: Hero ($4.59 in chips)
Seat 2: 6e117840 ($1.18 in chips)
Seat 3: edc59043 ($3.82 in chips)
Seat 4: 3989b5f1 ($4.4 in chips)
Seat 5: 68bed66e ($1.64 in chips)
Seat 6: db58be20 ($0.57 in chips)
68bed66e: posts small blind $0.01
db58be20: posts big blind $0.02
*** HOLE CARDS ***
Dealt to Hero [Tc 5d]
Dealt to 6e117840 
Dealt to edc59043 
Dealt to 3989b5f1 
Dealt to 68bed66e 
Dealt to db58be20 
Hero: folds
6e117840: folds
edc59043: calls $0.02
3989b5f1: raises $0.06 to $0.08
68bed66e: calls $0.07
db58be20: folds
edc59043: calls $0.06
*** FLOP *** [6s 9d 9h]
68bed66e: checks
edc59043: checks
3989b5f1: checks
*** TURN *** [6s 9d 9h] [4d]
68bed66e: checks
edc59043: checks
3989b5f1: checks
*** RIVER *** [6s 9d 9h 4d] [4c]
68bed66e: checks
edc59043: checks
3989b5f1: checks
68bed66e: shows [Ts Js] (Pair of Nines and Pair of Fours)
edc59043: shows [3s Qs] (Pair of Nines and Pair of Fours)
3989b5f1: shows [Ac Qc] (Pair of Nines and Pair of Fours)
*** SHOWDOWN ***
3989b5f1 collected $0.25 from pot
*** SUMMARY ***
Total pot $0.26 | Rake $0.01 | Jackpot $0 | Bingo $0 | Fortune $0 | Tax $0
Board [6s 9d 9h 4d 4c]
Seat 1: Hero folded before Flop (didn't bet)
Seat 2: 6e117840 folded before Flop (didn't bet)
Seat 3: edc59043 showed [3s Qs] and lost with Pair of Nines and Pair of Fours
Seat 4: 3989b5f1 (button) showed [Ac Qc] and won ($0.25) with Pair of Nines and Pair of Fours
Seat 5: 68bed66e (small blind) showed [Ts Js] and lost with Pair of Nines and Pair of Fours
Seat 6: db58be20 (big blind) folded before Flop


Poker Hand #HD50930841: Hold'em No Limit ($0.01/$0.02) - 2024/05/21 20:25:09
Table 'NLHYellow5' 6-max Seat #3 is the button
Seat 1: Hero ($4.59 in chips)
Seat 2: 6e117840 ($1.18 in chips)
Seat 3: edc59043 ($3.77 in chips)
Seat 4: 3989b5f1 ($4.41 in chips)
Seat 5: 68bed66e ($1.68 in chips)
Seat 6: db58be20 ($0.57 in chips)
3989b5f1: posts small blind $0.01
68bed66e: posts big blind $0.02
*** HOLE CARDS ***
Dealt to Hero [6d Kd]
Dealt to 6e117840 
Dealt to edc59043 
Dealt to 3989b5f1 
Dealt to 68bed66e 
Dealt to db58be20 
db58be20: folds
Hero: folds
6e117840: folds
edc59043: raises $0.02 to $0.04
3989b5f1: folds
68bed66e: calls $0.02
*** FLOP *** [5c Qh Js]
68bed66e: checks
edc59043: bets $0.05
68bed66e: folds
Uncalled bet ($0.05) returned to edc59043
*** SHOWDOWN ***
edc59043 collected $0.09 from pot
*** SUMMARY ***
Total pot $0.09 | Rake $0 | Jackpot $0 | Bingo $0 | Fortune $0 | Tax $0
Board [5c Qh Js]
Seat 1: Hero folded before Flop (didn't bet)
Seat 2: 6e117840 folded before Flop (didn't bet)
Seat 3: edc59043 (button) won ($0.09)
Seat 4: 3989b5f1 (small blind) folded before Flop
Seat 5: 68bed66e (big blind) folded on the Flop
Seat 6: db58be20 folded before Flop (didn't bet)


Poker Hand #HD50930820: Hold'em No Limit ($0.01/$0.02) - 2024/05/21 20:24:28
Table 'NLHYellow5' 6-max Seat #2 is the button
Seat 1: Hero ($4.59 in chips)
Seat 2: 6e117840 ($1.18 in chips)
Seat 3: edc59043 ($3.47 in chips)
Seat 4: 3989b5f1 ($4.57 in chips)
Seat 5: 68bed66e ($1.84 in chips)
Seat 6: db58be20 ($0.57 in chips)
edc59043: posts small blind $0.01
3989b5f1: posts big blind $0.02
*** HOLE CARDS ***
Dealt to Hero [Jh 5c]
Dealt to 6e117840 
Dealt to edc59043 
Dealt to 3989b5f1 
Dealt to 68bed66e 
Dealt to db58be20 
68bed66e: raises $0.06 to $0.08
db58be20: folds
Hero: folds
6e117840: folds
edc59043: calls $0.07
3989b5f1: calls $0.06
*** FLOP *** [Qd 7h 9h]
edc59043: checks
3989b5f1: bets $0.08
68bed66e: calls $0.08
edc59043: calls $0.08
*** TURN *** [Qd 7h 9h] [As]
edc59043: bets $0.48
3989b5f1: folds
68bed66e: folds
Uncalled bet ($0.48) returned to edc59043
*** SHOWDOWN ***
edc59043 collected $0.46 from pot
*** SUMMARY ***
Total pot $0.48 | Rake $0.02 | Jackpot $0 | Bingo $0 | Fortune $0 | Tax $0
Board [Qd 7h 9h As]
Seat 1: Hero folded before Flop (didn't bet)
Seat 2: 6e117840 (button) folded before Flop (didn't bet)
Seat 3: edc59043 (small blind) won ($0.46)
Seat 4: 3989b5f1 (big blind) folded on the Turn
Seat 5: 68bed66e folded on the Turn
Seat 6: db58be20 folded before Flop (didn't bet)


Poker Hand #HD50930788: Hold'em No Limit ($0.01/$0.02) - 2024/05/21 20:23:19
Table 'NLHYellow5' 6-max Seat #1 is the button
Seat 1: Hero ($4.59 in chips)
Seat 2: 6e117840 ($1.2 in chips)
Seat 3: edc59043 ($3.53 in chips)
Seat 4: 3989b5f1 ($4.57 in chips)
Seat 5: 68bed66e ($2.11 in chips)
Seat 6: db58be20 ($0.27 in chips)
6e117840: posts small blind $0.01
edc59043: posts big blind $0.02
*** HOLE CARDS ***
Dealt to Hero [Ks 6c]
Dealt to 6e117840 
Dealt to edc59043 
Dealt to 3989b5f1 
Dealt to 68bed66e 
Dealt to db58be20 
3989b5f1: folds
68bed66e: calls $0.02
db58be20: calls $0.02
Hero: folds
6e117840: calls $0.01
edc59043: checks
*** FLOP *** [Qc 9d 5h]
6e117840: checks
edc59043: checks
68bed66e: bets $0.04
db58be20: calls $0.04
6e117840: folds
edc59043: calls $0.04
*** TURN *** [Qc 9d 5h] [2d]
edc59043: checks
68bed66e: bets $0.1
db58be20: raises $0.11 to $0.21 and is all-in
edc59043: folds
68bed66e: calls $0.11
db58be20: shows [Qd 8d] (Pair of Queens)
68bed66e: shows [Qs Td] (Pair of Queens)
*** RIVER *** [Qc 9d 5h 2d] [Ad]
*** SHOWDOWN ***
db58be20 collected $0.57 from pot
*** SUMMARY ***
Total pot $0.62 | Rake $0.03 | Jackpot $0.02 | Bingo $0 | Fortune $0 | Tax $0
Board [Qc 9d 5h 2d Ad]
Seat 1: Hero (button) folded before Flop (didn't bet)
Seat 2: 6e117840 (small blind) folded on the Flop
Seat 3: edc59043 (big blind) folded on the Turn
Seat 4: 3989b5f1 folded before Flop (didn't bet)
Seat 5: 68bed66e showed [Qs Td] and lost with Pair of Queens
Seat 6: db58be20 showed [Qd 8d] and won ($0.57) with Ace High Flush


Poker Hand #HD50930766: Hold'em No Limit ($0.01/$0.02) - 2024/05/21 20:22:27
Table 'NLHYellow5' 6-max Seat #6 is the button
Seat 1: Hero ($4.52 in chips)
Seat 2: 6e117840 ($1.22 in chips)
Seat 3: edc59043 ($3.53 in chips)
Seat 4: 3989b5f1 ($4.57 in chips)
Seat 5: 68bed66e ($2.16 in chips)
Seat 6: db58be20 ($0.27 in chips)
Hero: posts small blind $0.01
6e117840: posts big blind $0.02
*** HOLE CARDS ***
Dealt to Hero [7d Jd]
Dealt to 6e117840 
Dealt to edc59043 
Dealt to 3989b5f1 
Dealt to 68bed66e 
Dealt to db58be20 
edc59043: folds
3989b5f1: folds
68bed66e: calls $0.02
db58be20: folds
Hero: calls $0.01
6e117840: checks
*** FLOP *** [3d Ks 4d]
Hero: bets $0.03
6e117840: folds
68bed66e: calls $0.03
*** TURN *** [3d Ks 4d] [8c]
Hero: bets $0.06
68bed66e: folds
Uncalled bet ($0.06) returned to Hero
*** SHOWDOWN ***
Hero collected $0.12 from pot
*** SUMMARY ***
Total pot $0.12 | Rake $0 | Jackpot $0 | Bingo $0 | Fortune $0 | Tax $0
Board [3d Ks 4d 8c]
Seat 1: Hero (small blind) won ($0.12)
Seat 2: 6e117840 (big blind) folded on the Flop
Seat 3: edc59043 folded before Flop (didn't bet)
Seat 4: 3989b5f1 folded before Flop (didn't bet)
Seat 5: 68bed66e folded on the Turn
Seat 6: db58be20 (button) folded before Flop (didn't bet)


Poker Hand #HD50930749: Hold'em No Limit ($0.01/$0.02) - 2024/05/21 20:22:01
Table 'NLHYellow5' 6-max Seat #5 is the button
Seat 1: Hero ($4.54 in chips)
Seat 3: edc59043 ($3.53 in chips)
Seat 4: 3989b5f1 ($4.65 in chips)
Seat 5: 68bed66e ($2.06 in chips)
Seat 6: db58be20 ($0.28 in chips)
db58be20: posts small blind $0.01
Hero: posts big blind $0.02
*** HOLE CARDS ***
Dealt to Hero [9h 7d]
Dealt to edc59043 
Dealt to 3989b5f1 
Dealt to 68bed66e 
Dealt to db58be20 
edc59043: folds
3989b5f1: raises $0.03 to $0.05
68bed66e: raises $0.03 to $0.08
db58be20: folds
Hero: folds
3989b5f1: calls $0.03
*** FLOP *** [9d 6d 4h]
3989b5f1: checks
68bed66e: bets $0.1
3989b5f1: folds
Uncalled bet ($0.1) returned to 68bed66e
*** SHOWDOWN ***
68bed66e collected $0.18 from pot
*** SUMMARY ***
Total pot $0.19 | Rake $0.01 | Jackpot $0 | Bingo $0 | Fortune $0 | Tax $0
Board [9d 6d 4h]
Seat 1: Hero (big blind) folded before Flop
Seat 3: edc59043 folded before Flop (didn't bet)
Seat 4: 3989b5f1 folded on the Flop
Seat 5: 68bed66e (button) won ($0.18)
Seat 6: db58be20 (small blind) folded before Flop


Poker Hand #HD50930733: Hold'em No Limit ($0.01/$0.02) - 2024/05/21 20:21:21
Table 'NLHYellow5' 6-max Seat #4 is the button
Seat 1: Hero ($4.68 in chips)
Seat 3: edc59043 ($3.53 in chips)
Seat 4: 3989b5f1 ($4.65 in chips)
Seat 5: 68bed66e ($2.07 in chips)
Seat 6: db58be20 ($0.14 in chips)
68bed66e: posts small blind $0.01
db58be20: posts big blind $0.02
*** HOLE CARDS ***
Dealt to Hero [Tc As]
Dealt to edc59043 
Dealt to 3989b5f1 
Dealt to 68bed66e 
Dealt to db58be20 
Hero: raises $0.03 to $0.05
edc59043: folds
3989b5f1: folds
68bed66e: folds
db58be20: calls $0.03
*** FLOP *** [2s 3h Jc]
db58be20: bets $0.09 and is all-in
Hero: calls $0.09
db58be20: shows [Js 9s] (Pair of Jacks)
Hero: shows [Tc As] (Ace-High)
*** TURN *** [2s 3h Jc] [4h]
*** RIVER *** [2s 3h Jc 4h] [9h]
*** SHOWDOWN ***
db58be20 collected $0.28 from pot
*** SUMMARY ***
Total pot $0.29 | Rake $0.01 | Jackpot $0 | Bingo $0 | Fortune $0 | Tax $0
Board [2s 3h Jc 4h 9h]
Seat 1: Hero showed [Tc As] and lost with Ace-High
Seat 3: edc59043 folded before Flop (didn't bet)
Seat 4: 3989b5f1 (button) folded before Flop (didn't bet)
Seat 5: 68bed66e (small blind) folded before Flop
Seat 6: db58be20 (big blind) showed [Js 9s] and won ($0.28) with Pair of Jacks and Pair of Nines


Poker Hand #HD50930718: Hold'em No Limit ($0.01/$0.02) - 2024/05/21 20:20:42
Table 'NLHYellow5' 6-max Seat #3 is the button
Seat 1: Hero ($4.57 in chips)
Seat 3: edc59043 ($3.53 in chips)
Seat 4: 3989b5f1 ($4.66 in chips)
Seat 5: 68bed66e ($2.09 in chips)
Seat 6: db58be20 ($0.23 in chips)
3989b5f1: posts small blind $0.01
68bed66e: posts big blind $0.02
*** HOLE CARDS ***
Dealt to Hero [9c 9h]
Dealt to edc59043 
Dealt to 3989b5f1 
Dealt to 68bed66e 
Dealt to db58be20 
db58be20: calls $0.02
Hero: raises $0.07 to $0.09
edc59043: folds
3989b5f1: folds
68bed66e: folds
db58be20: calls $0.07
*** FLOP *** [8h 2c Th]
db58be20: checks
Hero: bets $4.48 and is all-in
db58be20: folds
Uncalled bet ($4.48) returned to Hero
*** SHOWDOWN ***
Hero collected $0.2 from pot
*** SUMMARY ***
Total pot $0.21 | Rake $0.01 | Jackpot $0 | Bingo $0 | Fortune $0 | Tax $0
Board [8h 2c Th]
Seat 1: Hero won ($0.2)
Seat 3: edc59043 (button) folded before Flop (didn't bet)
Seat 4: 3989b5f1 (small blind) folded before Flop
Seat 5: 68bed66e (big blind) folded before Flop
Seat 6: db58be20 folded on the Flop


Poker Hand #HD50930704: Hold'em No Limit ($0.01/$0.02) - 2024/05/21 20:20:13
Table 'NLHYellow5' 6-max Seat #1 is the button
Seat 1: Hero ($4.57 in chips)
Seat 3: edc59043 ($3.54 in chips)
Seat 4: 3989b5f1 ($4.72 in chips)
Seat 5: 68bed66e ($2.02 in chips)
Seat 6: db58be20 ($0.23 in chips)
edc59043: posts small blind $0.01
3989b5f1: posts big blind $0.02
*** HOLE CARDS ***
Dealt to Hero [2s 6c]
Dealt to edc59043 
Dealt to 3989b5f1 
Dealt to 68bed66e 
Dealt to db58be20 
68bed66e: calls $0.02
db58be20: folds
Hero: folds
edc59043: folds
3989b5f1: checks
*** FLOP *** [3c 7h 2h]
3989b5f1: bets $0.02
68bed66e: raises $0.02 to $0.04
3989b5f1: calls $0.02
*** TURN *** [3c 7h 2h] [Ad]
3989b5f1: checks
68bed66e: bets $0.07
3989b5f1: folds
Uncalled bet ($0.07) returned to 68bed66e
*** SHOWDOWN ***
68bed66e collected $0.13 from pot
*** SUMMARY ***
Total pot $0.13 | Rake $0 | Jackpot $0 | Bingo $0 | Fortune $0 | Tax $0
Board [3c 7h 2h Ad]
Seat 1: Hero (button) folded before Flop (didn't bet)
Seat 3: edc59043 (small blind) folded before Flop
Seat 4: 3989b5f1 (big blind) folded on the Turn
Seat 5: 68bed66e won ($0.13)
Seat 6: db58be20 folded before Flop (didn't bet)


Poker Hand #HD50930695: Hold'em No Limit ($0.01/$0.02) - 2024/05/21 20:19:51
Table 'NLHYellow5' 6-max Seat #6 is the button
Seat 1: Hero ($4.58 in chips)
Seat 3: edc59043 ($3.56 in chips)
Seat 4: 3989b5f1 ($4.72 in chips)
Seat 5: 68bed66e ($1.99 in chips)
Seat 6: db58be20 ($0.23 in chips)
Hero: posts small blind $0.01
edc59043: posts big blind $0.02
*** HOLE CARDS ***
Dealt to Hero [7d Qh]
Dealt to edc59043 
Dealt to 3989b5f1 
Dealt to 68bed66e 
Dealt to db58be20 
3989b5f1: folds
68bed66e: calls $0.02
db58be20: folds
Hero: folds
edc59043: checks
*** FLOP *** [Jd 3h 6h]
edc59043: checks
68bed66e: bets $0.04
edc59043: folds
Uncalled bet ($0.04) returned to 68bed66e
*** SHOWDOWN ***
68bed66e collected $0.05 from pot
*** SUMMARY ***
Total pot $0.05 | Rake $0 | Jackpot $0 | Bingo $0 | Fortune $0 | Tax $0
Board [Jd 3h 6h]
Seat 1: Hero (small blind) folded before Flop
Seat 3: edc59043 (big blind) folded on the Flop
Seat 4: 3989b5f1 folded before Flop (didn't bet)
Seat 5: 68bed66e won ($0.05)
Seat 6: db58be20 (button) folded before Flop (didn't bet)


Poker Hand #HD50930675: Hold'em No Limit ($0.01/$0.02) - 2024/05/21 20:19:10
Table 'NLHYellow5' 6-max Seat #5 is the button
Seat 1: Hero ($4.6 in chips)
Seat 3: edc59043 ($3.56 in chips)
Seat 4: 3989b5f1 ($4.69 in chips)
Seat 5: 68bed66e ($1.99 in chips)
Seat 6: db58be20 ($0.24 in chips)
db58be20: posts small blind $0.01
Hero: posts big blind $0.02
*** HOLE CARDS ***
Dealt to Hero [7c 4s]
Dealt to edc59043 
Dealt to 3989b5f1 
Dealt to 68bed66e 
Dealt to db58be20 
edc59043: folds
3989b5f1: raises $0.03 to $0.05
68bed66e: folds
db58be20: folds
Hero: folds
Uncalled bet ($0.03) returned to 3989b5f1
*** SHOWDOWN ***
3989b5f1 collected $0.05 from pot
*** SUMMARY ***
Total pot $0.05 | Rake $0 | Jackpot $0 | Bingo $0 | Fortune $0 | Tax $0
Seat 1: Hero (big blind) folded before Flop
Seat 3: edc59043 folded before Flop (didn't bet)
Seat 4: 3989b5f1 collected ($0.05)
Seat 5: 68bed66e (button) folded before Flop (didn't bet)
Seat 6: db58be20 (small blind) folded before Flop


Poker Hand #HD50930649: Hold'em No Limit ($0.01/$0.02) - 2024/05/21 20:17:55
Table 'NLHYellow5' 6-max Seat #4 is the button
Seat 1: Hero ($4.49 in chips)
Seat 2: fcaa871e ($0.26 in chips)
Seat 3: edc59043 ($3.61 in chips)
Seat 4: 3989b5f1 ($4.69 in chips)
Seat 5: 68bed66e ($2 in chips)
Seat 6: db58be20 ($0.29 in chips)
68bed66e: posts small blind $0.01
db58be20: posts big blind $0.02
*** HOLE CARDS ***
Dealt to Hero [Ad As]
Dealt to fcaa871e 
Dealt to edc59043 
Dealt to 3989b5f1 
Dealt to 68bed66e 
Dealt to db58be20 
Hero: raises $0.03 to $0.05
fcaa871e: folds
edc59043: calls $0.05
3989b5f1: folds
68bed66e: folds
db58be20: calls $0.03
*** FLOP *** [4h 8s Qc]
db58be20: checks
Hero: bets $0.06
edc59043: folds
db58be20: folds
Uncalled bet ($0.06) returned to Hero
*** SHOWDOWN ***
Hero collected $0.16 from pot
*** SUMMARY ***
Total pot $0.16 | Rake $0 | Jackpot $0 | Bingo $0 | Fortune $0 | Tax $0
Board [4h 8s Qc]
Seat 1: Hero won ($0.16)
Seat 2: fcaa871e folded before Flop (didn't bet)
Seat 3: edc59043 folded on the Flop
Seat 4: 3989b5f1 (button) folded before Flop (didn't bet)
Seat 5: 68bed66e (small blind) folded before Flop
Seat 6: db58be20 (big blind) folded on the Flop


Poker Hand #HD50930630: Hold'em No Limit ($0.01/$0.02) - 2024/05/21 20:17:17
Table 'NLHYellow5' 6-max Seat #3 is the button
Seat 1: Hero ($4.49 in chips)
Seat 2: fcaa871e ($0.26 in chips)
Seat 3: edc59043 ($3.7 in chips)
Seat 4: 3989b5f1 ($4.7 in chips)
Seat 5: 68bed66e ($1.91 in chips)
Seat 6: db58be20 ($0.29 in chips)
3989b5f1: posts small blind $0.01
68bed66e: posts big blind $0.02
*** HOLE CARDS ***
Dealt to Hero [Td Qs]
Dealt to fcaa871e 
Dealt to edc59043 
Dealt to 3989b5f1 
Dealt to 68bed66e 
Dealt to db58be20 
db58be20: folds
Hero: folds
fcaa871e: folds
edc59043: raises $0.02 to $0.04
3989b5f1: folds
68bed66e: calls $0.02
*** FLOP *** [2c Th 6h]
68bed66e: checks
edc59043: bets $0.05
68bed66e: calls $0.05
*** TURN *** [2c Th 6h] [8d]
68bed66e: checks
edc59043: checks
*** RIVER *** [2c Th 6h 8d] [Js]
68bed66e: checks
edc59043: checks
68bed66e: shows [Ad 2d] (Pair of Twos)
edc59043: shows [4d 7d] (Jack-High)
*** SHOWDOWN ***
68bed66e collected $0.18 from pot
*** SUMMARY ***
Total pot $0.19 | Rake $0.01 | Jackpot $0 | Bingo $0 | Fortune $0 | Tax $0
Board [2c Th 6h 8d Js]
Seat 1: Hero folded before Flop (didn't bet)
Seat 2: fcaa871e folded before Flop (didn't bet)
Seat 3: edc59043 (button) showed [4d 7d] and lost with Jack-High
Seat 4: 3989b5f1 (small blind) folded before Flop
Seat 5: 68bed66e (big blind) showed [Ad 2d] and won ($0.18) with Pair of Twos
Seat 6: db58be20 folded before Flop (didn't bet)


Poker Hand #HD50930591: Hold'em No Limit ($0.01/$0.02) - 2024/05/21 20:15:42
Table 'NLHYellow5' 6-max Seat #2 is the button
Seat 1: Hero ($4.49 in chips)
Seat 2: fcaa871e ($0.7 in chips)
Seat 3: edc59043 ($3.71 in chips)
Seat 4: 3989b5f1 ($4.76 in chips)
Seat 5: 68bed66e ($1.46 in chips)
Seat 6: db58be20 ($0.29 in chips)
edc59043: posts small blind $0.01
3989b5f1: posts big blind $0.02
*** HOLE CARDS ***
Dealt to Hero [5s 4c]
Dealt to fcaa871e 
Dealt to edc59043 
Dealt to 3989b5f1 
Dealt to 68bed66e 
Dealt to db58be20 
68bed66e: calls $0.02
db58be20: folds
Hero: folds
fcaa871e: raises $0.04 to $0.06
edc59043: folds
3989b5f1: calls $0.04
68bed66e: calls $0.04
*** FLOP *** [Tc 9c 9d]
3989b5f1: checks
68bed66e: checks
fcaa871e: checks
*** TURN *** [Tc 9c 9d] [Qs]
3989b5f1: checks
68bed66e: bets $0.19
fcaa871e: calls $0.19
3989b5f1: folds
*** RIVER *** [Tc 9c 9d Qs] [8s]
68bed66e: bets $0.19
fcaa871e: calls $0.19
68bed66e: shows [As 9s] (Three Nines)
fcaa871e: shows [8c 7c] (Pair of Nines and Pair of Eights)
*** SHOWDOWN ***
68bed66e collected $0.89 from pot
*** SUMMARY ***
Total pot $0.95 | Rake $0.04 | Jackpot $0.02 | Bingo $0 | Fortune $0 | Tax $0
Board [Tc 9c 9d Qs 8s]
Seat 1: Hero folded before Flop (didn't bet)
Seat 2: fcaa871e (button) showed [8c 7c] and lost with Pair of Nines and Pair of Eights
Seat 3: edc59043 (small blind) folded before Flop
Seat 4: 3989b5f1 (big blind) folded on the Turn
Seat 5: 68bed66e showed [As 9s] and won ($0.89) with Three Nines
Seat 6: db58be20 folded before Flop (didn't bet)


Poker Hand #HD50930558: Hold'em No Limit ($0.01/$0.02) - 2024/05/21 20:14:30
Table 'NLHYellow5' 6-max Seat #1 is the button
Seat 1: Hero ($4.49 in chips)
Seat 2: fcaa871e ($2.65 in chips)
Seat 3: edc59043 ($1.95 in chips)
Seat 4: 3989b5f1 ($4.76 in chips)
Seat 5: 68bed66e ($1.46 in chips)
Seat 6: db58be20 ($0.31 in chips)
fcaa871e: posts small blind $0.01
edc59043: posts big blind $0.02
*** HOLE CARDS ***
Dealt to Hero [8d 6c]
Dealt to fcaa871e 
Dealt to edc59043 
Dealt to 3989b5f1 
Dealt to 68bed66e 
Dealt to db58be20 
3989b5f1: folds
68bed66e: folds
db58be20: calls $0.02
Hero: folds
fcaa871e: calls $0.01
edc59043: checks
*** FLOP *** [Jh Td 9s]
fcaa871e: checks
edc59043: bets $0.06
db58be20: folds
fcaa871e: calls $0.06
*** TURN *** [Jh Td 9s] [2c]
fcaa871e: checks
edc59043: bets $0.18
fcaa871e: calls $0.18
*** RIVER *** [Jh Td 9s 2c] [Th]
fcaa871e: checks
edc59043: bets $0.27
fcaa871e: raises $2.12 to $2.39 and is all-in
edc59043: calls $1.42 and is all-in
Uncalled bet ($0.7) returned to fcaa871e
fcaa871e: shows [8h Qd] (Queens-High Straight)
edc59043: shows [2s Ts] (Tens Full over Twos)
*** SHOWDOWN ***
edc59043 collected $3.71 from pot
*** SUMMARY ***
Total pot $3.92 | Rake $0.19 | Jackpot $0.02 | Bingo $0 | Fortune $0 | Tax $0
Board [Jh Td 9s 2c Th]
Seat 1: Hero (button) folded before Flop (didn't bet)
Seat 2: fcaa871e (small blind) showed [8h Qd] and lost with Queens-High Straight
Seat 3: edc59043 (big blind) showed [2s Ts] and won ($3.71) with Tens Full over Twos
Seat 4: 3989b5f1 folded before Flop (didn't bet)
Seat 5: 68bed66e folded before Flop (didn't bet)
Seat 6: db58be20 folded on the Flop


Poker Hand #HD50930529: Hold'em No Limit ($0.01/$0.02) - 2024/05/21 20:13:12
Table 'NLHYellow5' 6-max Seat #6 is the button
Seat 1: Hero ($4.5 in chips)
Seat 2: fcaa871e ($2.89 in chips)
Seat 3: edc59043 ($1.95 in chips)
Seat 4: 3989b5f1 ($4.53 in chips)
Seat 5: 68bed66e ($1.46 in chips)
Seat 6: db58be20 ($0.31 in chips)
Hero: posts small blind $0.01
fcaa871e: posts big blind $0.02
*** HOLE CARDS ***
Dealt to Hero [7d Jc]
Dealt to fcaa871e 
Dealt to edc59043 
Dealt to 3989b5f1 
Dealt to 68bed66e 
Dealt to db58be20 
edc59043: folds
3989b5f1: raises $0.03 to $0.05
68bed66e: folds
db58be20: folds
Hero: folds
fcaa871e: calls $0.03
*** FLOP *** [9h 3c As]
fcaa871e: checks
3989b5f1: bets $0.04
fcaa871e: calls $0.04
*** TURN *** [9h 3c As] [4s]
fcaa871e: checks
3989b5f1: checks
*** RIVER *** [9h 3c As 4s] [Js]
fcaa871e: checks
3989b5f1: bets $0.15
fcaa871e: calls $0.15
3989b5f1: shows [Ks 8s] (Ace High Flush)
fcaa871e: shows [2s Ad] (Pair of Aces)
*** SHOWDOWN ***
3989b5f1 collected $0.47 from pot
*** SUMMARY ***
Total pot $0.49 | Rake $0.02 | Jackpot $0 | Bingo $0 | Fortune $0 | Tax $0
Board [9h 3c As 4s Js]
Seat 1: Hero (small blind) folded before Flop
Seat 2: fcaa871e (big blind) showed [2s Ad] and lost with Pair of Aces
Seat 3: edc59043 folded before Flop (didn't bet)
Seat 4: 3989b5f1 showed [Ks 8s] and won ($0.47) with Ace High Flush
Seat 5: 68bed66e folded before Flop (didn't bet)
Seat 6: db58be20 (button) folded before Flop (didn't bet)


Poker Hand #HD50930483: Hold'em No Limit ($0.01/$0.02) - 2024/05/21 20:11:21
Table 'NLHYellow5' 6-max Seat #5 is the button
Seat 1: Hero ($4.56 in chips)
Seat 2: fcaa871e ($2.44 in chips)
Seat 3: edc59043 ($1.95 in chips)
Seat 4: 3989b5f1 ($4.53 in chips)
Seat 5: 68bed66e ($1.76 in chips)
Seat 6: db58be20 ($0.45 in chips)
db58be20: posts small blind $0.01
Hero: posts big blind $0.02
*** HOLE CARDS ***
Dealt to Hero [Ts 7s]
Dealt to fcaa871e 
Dealt to edc59043 
Dealt to 3989b5f1 
Dealt to 68bed66e 
Dealt to db58be20 
fcaa871e: raises $0.04 to $0.06
edc59043: folds
3989b5f1: folds
68bed66e: calls $0.06
db58be20: calls $0.05
Hero: calls $0.04
*** FLOP *** [3d 2c Ah]
db58be20: checks
Hero: checks
fcaa871e: bets $0.08
68bed66e: calls $0.08
db58be20: calls $0.08
Hero: folds
*** TURN *** [3d 2c Ah] [6d]
db58be20: checks
fcaa871e: checks
68bed66e: bets $0.16
db58be20: folds
fcaa871e: raises $0.8 to $0.96
68bed66e: folds
Uncalled bet ($0.8) returned to fcaa871e
*** SHOWDOWN ***
fcaa871e collected $0.75 from pot
*** SUMMARY ***
Total pot $0.8 | Rake $0.03 | Jackpot $0.02 | Bingo $0 | Fortune $0 | Tax $0
Board [3d 2c Ah 6d]
Seat 1: Hero (big blind) folded on the Flop
Seat 2: fcaa871e won ($0.75)
Seat 3: edc59043 folded before Flop (didn't bet)
Seat 4: 3989b5f1 folded before Flop (didn't bet)
Seat 5: 68bed66e (button) folded on the Turn
Seat 6: db58be20 (small blind) folded on the Turn


Poker Hand #HD50930456: Hold'em No Limit ($0.01/$0.02) - 2024/05/21 20:10:22
Table 'NLHYellow5' 6-max Seat #4 is the button
Seat 1: Hero ($4.56 in chips)
Seat 2: fcaa871e ($2.44 in chips)
Seat 3: edc59043 ($1.95 in chips)
Seat 4: 3989b5f1 ($4.58 in chips)
Seat 5: 68bed66e ($1.66 in chips)
Seat 6: db58be20 ($0.5 in chips)
68bed66e: posts small blind $0.01
db58be20: posts big blind $0.02
*** HOLE CARDS ***
Dealt to Hero [7d Kh]
Dealt to fcaa871e 
Dealt to edc59043 
Dealt to 3989b5f1 
Dealt to 68bed66e 
Dealt to db58be20 
Hero: folds
fcaa871e: folds
edc59043: folds
3989b5f1: raises $0.03 to $0.05
68bed66e: calls $0.04
db58be20: calls $0.03
*** FLOP *** [7s Jd Ks]
68bed66e: checks
db58be20: checks
3989b5f1: checks
*** TURN *** [7s Jd Ks] [5s]
68bed66e: checks
db58be20: checks
3989b5f1: checks
*** RIVER *** [7s Jd Ks 5s] [2c]
68bed66e: bets $0.05
db58be20: folds
3989b5f1: folds
Uncalled bet ($0.05) returned to 68bed66e
*** SHOWDOWN ***
68bed66e collected $0.15 from pot
*** SUMMARY ***
Total pot $0.15 | Rake $0 | Jackpot $0 | Bingo $0 | Fortune $0 | Tax $0
Board [7s Jd Ks 5s 2c]
Seat 1: Hero folded before Flop (didn't bet)
Seat 2: fcaa871e folded before Flop (didn't bet)
Seat 3: edc59043 folded before Flop (didn't bet)
Seat 4: 3989b5f1 (button) folded on the River
Seat 5: 68bed66e (small blind) won ($0.15)
Seat 6: db58be20 (big blind) folded on the River


Poker Hand #HD50930413: Hold'em No Limit ($0.01/$0.02) - 2024/05/21 20:08:58
Table 'NLHYellow5' 6-max Seat #3 is the button
Seat 1: Hero ($4.56 in chips)
Seat 2: fcaa871e ($2.49 in chips)
Seat 3: edc59043 ($1.97 in chips)
Seat 4: 3989b5f1 ($4.49 in chips)
Seat 5: 68bed66e ($1.68 in chips)
3989b5f1: posts small blind $0.01
68bed66e: posts big blind $0.02
*** HOLE CARDS ***
Dealt to Hero [4d 9c]
Dealt to fcaa871e 
Dealt to edc59043 
Dealt to 3989b5f1 
Dealt to 68bed66e 
Hero: folds
fcaa871e: calls $0.02
edc59043: calls $0.02
3989b5f1: calls $0.01
68bed66e: checks
*** FLOP *** [5c Jd 3s]
3989b5f1: bets $0.03
68bed66e: folds
fcaa871e: calls $0.03
edc59043: folds
*** TURN *** [5c Jd 3s] [3c]
3989b5f1: checks
fcaa871e: checks
*** RIVER *** [5c Jd 3s 3c] [5d]
3989b5f1: checks
fcaa871e: checks
3989b5f1: shows [Qd Jc] (Pair of Jacks and Pair of Fives)
fcaa871e: shows [Qc Th] (Pair of Fives and Pair of Treys)
*** SHOWDOWN ***
3989b5f1 collected $0.14 from pot
*** SUMMARY ***
Total pot $0.14 | Rake $0 | Jackpot $0 | Bingo $0 | Fortune $0 | Tax $0
Board [5c Jd 3s 3c 5d]
Seat 1: Hero folded before Flop (didn't bet)
Seat 2: fcaa871e showed [Qc Th] and lost with Pair of Fives and Pair of Treys
Seat 3: edc59043 (button) folded on the Flop
Seat 4: 3989b5f1 (small blind) showed [Qd Jc] and won ($0.14) with Pair of Jacks and Pair of Fives
Seat 5: 68bed66e (big blind) folded on the Flop


Poker Hand #HD50930383: Hold'em No Limit ($0.01/$0.02) - 2024/05/21 20:07:48
Table 'NLHYellow5' 6-max Seat #2 is the button
Seat 1: Hero ($4.56 in chips)
Seat 2: fcaa871e ($2.63 in chips)
Seat 3: edc59043 ($1.98 in chips)
Seat 4: 3989b5f1 ($4.51 in chips)
Seat 5: 68bed66e ($1.52 in chips)
edc59043: posts small blind $0.01
3989b5f1: posts big blind $0.02
*** HOLE CARDS ***
Dealt to Hero [Ks 8c]
Dealt to fcaa871e 
Dealt to edc59043 
Dealt to 3989b5f1 
Dealt to 68bed66e 
68bed66e: calls $0.02
Hero: folds
fcaa871e: raises $0.04 to $0.06
edc59043: folds
3989b5f1: folds
68bed66e: calls $0.04
*** FLOP *** [4s 9s 6h]
68bed66e: bets $0.08
fcaa871e: calls $0.08
*** TURN *** [4s 9s 6h] [6c]
68bed66e: checks
fcaa871e: checks
*** RIVER *** [4s 9s 6h 6c] [9h]
68bed66e: bets $0.31
fcaa871e: folds
Uncalled bet ($0.31) returned to 68bed66e
*** SHOWDOWN ***
68bed66e collected $0.3 from pot
*** SUMMARY ***
Total pot $0.31 | Rake $0.01 | Jackpot $0 | Bingo $0 | Fortune $0 | Tax $0
Board [4s 9s 6h 6c 9h]
Seat 1: Hero folded before Flop (didn't bet)
Seat 2: fcaa871e (button) folded on the River
Seat 3: edc59043 (small blind) folded before Flop
Seat 4: 3989b5f1 (big blind) folded before Flop
Seat 5: 68bed66e won ($0.3)


Poker Hand #HD50930370: Hold'em No Limit ($0.01/$0.02) - 2024/05/21 20:07:15
Table 'NLHYellow5' 6-max Seat #1 is the button
Seat 1: Hero ($4.56 in chips)
Seat 2: fcaa871e ($2.61 in chips)
Seat 3: edc59043 ($2 in chips)
Seat 4: 3989b5f1 ($4.51 in chips)
Seat 5: 68bed66e ($1.52 in chips)
fcaa871e: posts small blind $0.01
edc59043: posts big blind $0.02
*** HOLE CARDS ***
Dealt to Hero [Qc 6h]
Dealt to fcaa871e 
Dealt to edc59043 
Dealt to 3989b5f1 
Dealt to 68bed66e 
3989b5f1: folds
68bed66e: folds
Hero: folds
fcaa871e: calls $0.01
edc59043: checks
*** FLOP *** [7c 7h Tc]
fcaa871e: checks
edc59043: checks
*** TURN *** [7c 7h Tc] [9s]
fcaa871e: checks
edc59043: checks
*** RIVER *** [7c 7h Tc 9s] [2s]
fcaa871e: bets $0.04
edc59043: folds
Uncalled bet ($0.04) returned to fcaa871e
*** SHOWDOWN ***
fcaa871e collected $0.04 from pot
*** SUMMARY ***
Total pot $0.04 | Rake $0 | Jackpot $0 | Bingo $0 | Fortune $0 | Tax $0
Board [7c 7h Tc 9s 2s]
Seat 1: Hero (button) folded before Flop (didn't bet)
Seat 2: fcaa871e (small blind) won ($0.04)
Seat 3: edc59043 (big blind) folded on the River
Seat 4: 3989b5f1 folded before Flop (didn't bet)
Seat 5: 68bed66e folded before Flop (didn't bet)


Poker Hand #HD50930328: Hold'em No Limit ($0.01/$0.02) - 2024/05/21 20:05:46
Table 'NLHYellow5' 6-max Seat #5 is the button
Seat 1: Hero ($5.57 in chips)
Seat 2: fcaa871e ($2.66 in chips)
Seat 4: 3989b5f1 ($3.57 in chips)
Seat 5: 68bed66e ($1.52 in chips)
Hero: posts small blind $0.01
fcaa871e: posts big blind $0.02
*** HOLE CARDS ***
Dealt to Hero [6s 9s]
Dealt to fcaa871e 
Dealt to 3989b5f1 
Dealt to 68bed66e 
3989b5f1: raises $0.03 to $0.05
68bed66e: folds
Hero: calls $0.04
fcaa871e: calls $0.03
*** FLOP *** [9c Th 5c]
Hero: checks
fcaa871e: checks
3989b5f1: bets $0.05
Hero: raises $0.13 to $0.18
fcaa871e: folds
3989b5f1: calls $0.13
*** TURN *** [9c Th 5c] [4c]
Hero: bets $0.26
3989b5f1: calls $0.26
*** RIVER *** [9c Th 5c 4c] [5d]
Hero: bets $0.52
3989b5f1: calls $0.52
Hero: shows [6s 9s] (Pair of Nines and Pair of Fives)
3989b5f1: shows [Qc 8c] (Queen High Flush)
*** SHOWDOWN ***
3989b5f1 collected $1.95 from pot
*** SUMMARY ***
Total pot $2.07 | Rake $0.1 | Jackpot $0.02 | Bingo $0 | Fortune $0 | Tax $0
Board [9c Th 5c 4c 5d]
Seat 1: Hero (small blind) showed [6s 9s] and lost with Pair of Nines and Pair of Fives
Seat 2: fcaa871e (big blind) folded on the Flop
Seat 4: 3989b5f1 showed [Qc 8c] and won ($1.95) with Queen High Flush
Seat 5: 68bed66e (button) folded before Flop (didn't bet)


Poker Hand #HD50930305: Hold'em No Limit ($0.01/$0.02) - 2024/05/21 20:04:38
Table 'NLHYellow5' 6-max Seat #4 is the button
Seat 1: Hero ($5.59 in chips)
Seat 2: fcaa871e ($2.54 in chips)
Seat 4: 3989b5f1 ($3.57 in chips)
Seat 5: 68bed66e ($1.63 in chips)
68bed66e: posts small blind $0.01
Hero: posts big blind $0.02
*** HOLE CARDS ***
Dealt to Hero [Kd 5h]
Dealt to fcaa871e 
Dealt to 3989b5f1 
Dealt to 68bed66e 
fcaa871e: calls $0.02
3989b5f1: folds
68bed66e: calls $0.01
Hero: checks
*** FLOP *** [6d Ah Th]
68bed66e: bets $0.03
Hero: folds
fcaa871e: calls $0.03
*** TURN *** [6d Ah Th] [Ad]
68bed66e: bets $0.06
fcaa871e: calls $0.06
*** RIVER *** [6d Ah Th Ad] [As]
68bed66e: checks
fcaa871e: checks
68bed66e: shows [9c 8d] (Three Aces)
fcaa871e: shows [3d 3h] (Aces Full over Treys)
*** SHOWDOWN ***
fcaa871e collected $0.23 from pot
*** SUMMARY ***
Total pot $0.24 | Rake $0.01 | Jackpot $0 | Bingo $0 | Fortune $0 | Tax $0
Board [6d Ah Th Ad As]
Seat 1: Hero (big blind) folded on the Flop
Seat 2: fcaa871e showed [3d 3h] and won ($0.23) with Aces Full over Treys
Seat 4: 3989b5f1 (button) folded before Flop (didn't bet)
Seat 5: 68bed66e (small blind) showed [9c 8d] and lost with Three Aces


Poker Hand #HD50930280: Hold'em No Limit ($0.01/$0.02) - 2024/05/21 20:03:29
Table 'NLHYellow5' 6-max Seat #2 is the button
Seat 1: Hero ($5.59 in chips)
Seat 2: fcaa871e ($2.56 in chips)
Seat 3: 1fb9e6f8 ($1.01 in chips)
Seat 4: 3989b5f1 ($2.6 in chips)
Seat 5: 68bed66e ($1.69 in chips)
1fb9e6f8: posts small blind $0.01
3989b5f1: posts big blind $0.02
*** HOLE CARDS ***
Dealt to Hero [Jh 5h]
Dealt to fcaa871e 
Dealt to 1fb9e6f8 
Dealt to 3989b5f1 
Dealt to 68bed66e 
68bed66e: calls $0.02
Hero: folds
fcaa871e: calls $0.02
1fb9e6f8: calls $0.01
3989b5f1: checks
*** FLOP *** [3c 2s 8s]
1fb9e6f8: checks
3989b5f1: bets $0.04
68bed66e: calls $0.04
fcaa871e: folds
1fb9e6f8: raises $0.07 to $0.11
3989b5f1: raises $0.19 to $0.3
68bed66e: folds
1fb9e6f8: calls $0.19
*** TURN *** [3c 2s 8s] [2d]
1fb9e6f8: bets $0.69 and is all-in
3989b5f1: calls $0.69
1fb9e6f8: shows [7s 8h] (Pair of Eights and Pair of Twos)
3989b5f1: shows [Ks 3s] (Pair of Treys and Pair of Twos)
*** RIVER *** [3c 2s 8s 2d] [Kd]
*** SHOWDOWN ***
3989b5f1 collected $1.98 from pot
*** SUMMARY ***
Total pot $2.1 | Rake $0.1 | Jackpot $0.02 | Bingo $0 | Fortune $0 | Tax $0
Board [3c 2s 8s 2d Kd]
Seat 1: Hero folded before Flop (didn't bet)
Seat 2: fcaa871e (button) folded on the Flop
Seat 3: 1fb9e6f8 (small blind) showed [7s 8h] and lost with Pair of Eights and Pair of Twos
Seat 4: 3989b5f1 (big blind) showed [Ks 3s] and won ($1.98) with Pair of Kings and Pair of Treys
Seat 5: 68bed66e folded on the Flop


Poker Hand #HD50930229: Hold'em No Limit ($0.01/$0.02) - 2024/05/21 20:01:43
Table 'NLHYellow5' 6-max Seat #1 is the button
Seat 1: Hero ($5.59 in chips)
Seat 2: fcaa871e ($2.84 in chips)
Seat 3: 1fb9e6f8 ($1.03 in chips)
Seat 4: 3989b5f1 ($2.27 in chips)
Seat 5: 68bed66e ($1.77 in chips)
fcaa871e: posts small blind $0.01
1fb9e6f8: posts big blind $0.02
*** HOLE CARDS ***
Dealt to Hero [4c 7c]
Dealt to fcaa871e 
Dealt to 1fb9e6f8 
Dealt to 3989b5f1 
Dealt to 68bed66e 
3989b5f1: raises $0.03 to $0.05
68bed66e: raises $0.03 to $0.08
Hero: folds
fcaa871e: calls $0.07
1fb9e6f8: folds
3989b5f1: calls $0.03
*** FLOP *** [3c 8h 9c]
fcaa871e: checks
3989b5f1: bets $0.2
68bed66e: folds
fcaa871e: calls $0.2
*** TURN *** [3c 8h 9c] [Ks]
fcaa871e: checks
3989b5f1: checks
*** RIVER *** [3c 8h 9c Ks] [7s]
fcaa871e: checks
3989b5f1: checks
fcaa871e: shows [Ad Qc] (Ace-High)
3989b5f1: shows [Th 9h] (Pair of Nines)
*** SHOWDOWN ***
3989b5f1 collected $0.61 from pot
*** SUMMARY ***
Total pot $0.66 | Rake $0.03 | Jackpot $0.02 | Bingo $0 | Fortune $0 | Tax $0
Board [3c 8h 9c Ks 7s]
Seat 1: Hero (button) folded before Flop (didn't bet)
Seat 2: fcaa871e (small blind) showed [Ad Qc] and lost with Ace-High
Seat 3: 1fb9e6f8 (big blind) folded before Flop
Seat 4: 3989b5f1 showed [Th 9h] and won ($0.61) with Pair of Nines
Seat 5: 68bed66e folded on the Flop


Poker Hand #HD50930217: Hold'em No Limit ($0.01/$0.02) - 2024/05/21 20:01:18
Table 'NLHYellow5' 6-max Seat #5 is the button
Seat 1: Hero ($5.6 in chips)
Seat 2: fcaa871e ($2.81 in chips)
Seat 3: 1fb9e6f8 ($1.03 in chips)
Seat 4: 3989b5f1 ($2.27 in chips)
Seat 5: 68bed66e ($1.79 in chips)
Hero: posts small blind $0.01
fcaa871e: posts big blind $0.02
*** HOLE CARDS ***
Dealt to Hero [3s 8s]
Dealt to fcaa871e 
Dealt to 1fb9e6f8 
Dealt to 3989b5f1 
Dealt to 68bed66e 
1fb9e6f8: folds
3989b5f1: folds
68bed66e: calls $0.02
Hero: folds
fcaa871e: checks
*** FLOP *** [Th 2h Jd]
fcaa871e: bets $0.02
68bed66e: folds
Uncalled bet ($0.02) returned to fcaa871e
*** SHOWDOWN ***
fcaa871e collected $0.05 from pot
*** SUMMARY ***
Total pot $0.05 | Rake $0 | Jackpot $0 | Bingo $0 | Fortune $0 | Tax $0
Board [Th 2h Jd]
Seat 1: Hero (small blind) folded before Flop
Seat 2: fcaa871e (big blind) won ($0.05)
Seat 3: 1fb9e6f8 folded before Flop (didn't bet)
Seat 4: 3989b5f1 folded before Flop (didn't bet)
Seat 5: 68bed66e (button) folded on the Flop


Poker Hand #HD50930208: Hold'em No Limit ($0.01/$0.02) - 2024/05/21 20:00:59
Table 'NLHYellow5' 6-max Seat #4 is the button
Seat 1: Hero ($5.62 in chips)
Seat 2: fcaa871e ($2.81 in chips)
Seat 3: 1fb9e6f8 ($1 in chips)
Seat 4: 3989b5f1 ($2.27 in chips)
Seat 5: 68bed66e ($1.8 in chips)
68bed66e: posts small blind $0.01
Hero: posts big blind $0.02
1fb9e6f8: posts missed blind $0.01
1fb9e6f8: posts big blind $0.02
*** HOLE CARDS ***
Dealt to Hero [6s Qh]
Dealt to fcaa871e 
Dealt to 1fb9e6f8 
Dealt to 3989b5f1 
Dealt to 68bed66e 
fcaa871e: folds
1fb9e6f8: raises $0.02 to $0.04
3989b5f1: folds
68bed66e: folds
Hero: folds
Uncalled bet ($0.02) returned to 1fb9e6f8
*** SHOWDOWN ***
1fb9e6f8 collected $0.06 from pot
*** SUMMARY ***
Total pot $0.06 | Rake $0 | Jackpot $0 | Bingo $0 | Fortune $0 | Tax $0
Seat 1: Hero (big blind) folded before Flop
Seat 2: fcaa871e folded before Flop (didn't bet)
Seat 3: 1fb9e6f8 collected ($0.06)
Seat 4: 3989b5f1 (button) folded before Flop (didn't bet)
Seat 5: 68bed66e (small blind) folded before Flop


Poker Hand #HD50930183: Hold'em No Limit ($0.01/$0.02) - 2024/05/21 20:00:00
Table 'NLHYellow5' 6-max Seat #2 is the button
Seat 1: Hero ($5.62 in chips)
Seat 2: fcaa871e ($2.7 in chips)
Seat 4: 3989b5f1 ($2.28 in chips)
Seat 5: 68bed66e ($1.91 in chips)
3989b5f1: posts small blind $0.01
68bed66e: posts big blind $0.02
*** HOLE CARDS ***
Dealt to Hero [6h Th]
Dealt to fcaa871e 
Dealt to 3989b5f1 
Dealt to 68bed66e 
Hero: folds
fcaa871e: calls $0.02
3989b5f1: folds
68bed66e: checks
*** FLOP *** [6c Jd 9s]
68bed66e: checks
fcaa871e: checks
*** TURN *** [6c Jd 9s] [6s]
68bed66e: bets $0.03
fcaa871e: calls $0.03
*** RIVER *** [6c Jd 9s 6s] [3h]
68bed66e: bets $0.06
fcaa871e: calls $0.06
68bed66e: shows [2s As] (Pair of Sixes)
fcaa871e: shows [5d 5c] (Pair of Sixes and Pair of Fives)
*** SHOWDOWN ***
fcaa871e collected $0.22 from pot
*** SUMMARY ***
Total pot $0.23 | Rake $0.01 | Jackpot $0 | Bingo $0 | Fortune $0 | Tax $0
Board [6c Jd 9s 6s 3h]
Seat 1: Hero folded before Flop (didn't bet)
Seat 2: fcaa871e (button) showed [5d 5c] and won ($0.22) with Pair of Sixes and Pair of Fives
Seat 4: 3989b5f1 (small blind) folded before Flop
Seat 5: 68bed66e (big blind) showed [2s As] and lost with Pair of Sixes


Poker Hand #HD50930160: Hold'em No Limit ($0.01/$0.02) - 2024/05/21 19:59:00
Table 'NLHYellow5' 6-max Seat #1 is the button
Seat 1: Hero ($5.68 in chips)
Seat 2: fcaa871e ($2.71 in chips)
Seat 4: 3989b5f1 ($2.3 in chips)
Seat 5: 68bed66e ($1.82 in chips)
fcaa871e: posts small blind $0.01
3989b5f1: posts big blind $0.02
*** HOLE CARDS ***
Dealt to Hero [Td 9d]
Dealt to fcaa871e 
Dealt to 3989b5f1 
Dealt to 68bed66e 
68bed66e: calls $0.02
Hero: raises $0.04 to $0.06
fcaa871e: folds
3989b5f1: folds
68bed66e: calls $0.04
*** FLOP *** [5s 2c 8d]
68bed66e: checks
Hero: checks
*** TURN *** [5s 2c 8d] [8s]
68bed66e: checks
Hero: checks
*** RIVER *** [5s 2c 8d 8s] [Jh]
68bed66e: checks
Hero: checks
68bed66e: shows [6d Kh] (Pair of Eights)
Hero: shows [Td 9d] (Pair of Eights)
*** SHOWDOWN ***
68bed66e collected $0.15 from pot
*** SUMMARY ***
Total pot $0.15 | Rake $0 | Jackpot $0 | Bingo $0 | Fortune $0 | Tax $0
Board [5s 2c 8d 8s Jh]
Seat 1: Hero (button) showed [Td 9d] and lost with Pair of Eights
Seat 2: fcaa871e (small blind) folded before Flop
Seat 4: 3989b5f1 (big blind) folded before Flop
Seat 5: 68bed66e showed [6d Kh] and won ($0.15) with Pair of Eights


Poker Hand #HD50930126: Hold'em No Limit ($0.01/$0.02) - 2024/05/21 19:57:54
Table 'NLHYellow5' 6-max Seat #5 is the button
Seat 1: Hero ($5.69 in chips)
Seat 2: fcaa871e ($2.07 in chips)
Seat 3: 1fb9e6f8 ($0.35 in chips)
Seat 4: 3989b5f1 ($2.65 in chips)
Seat 5: 68bed66e ($1.82 in chips)
Hero: posts small blind $0.01
fcaa871e: posts big blind $0.02
*** HOLE CARDS ***
Dealt to Hero [5h 3h]
Dealt to fcaa871e 
Dealt to 1fb9e6f8 
Dealt to 3989b5f1 
Dealt to 68bed66e 
1fb9e6f8: calls $0.02
3989b5f1: raises $0.06 to $0.08
68bed66e: folds
Hero: folds
fcaa871e: calls $0.06
1fb9e6f8: calls $0.06
*** FLOP *** [6h Ks Ah]
fcaa871e: checks
1fb9e6f8: checks
3989b5f1: checks
*** TURN *** [6h Ks Ah] [As]
fcaa871e: checks
1fb9e6f8: bets $0.27 and is all-in
3989b5f1: calls $0.27
fcaa871e: raises $1.06 to $1.33
3989b5f1: folds
Uncalled bet ($1.06) returned to fcaa871e
fcaa871e: shows [Ac Ad] (Four Aces)
1fb9e6f8: shows [Ts 8s] (Pair of Aces)
*** RIVER *** [6h Ks Ah As] [8d]
*** SHOWDOWN ***
fcaa871e collected $0.99 from pot
*** SUMMARY ***
Total pot $1.06 | Rake $0.05 | Jackpot $0.02 | Bingo $0 | Fortune $0 | Tax $0
Board [6h Ks Ah As 8d]
Seat 1: Hero (small blind) folded before Flop
Seat 2: fcaa871e (big blind) showed [Ac Ad] and won ($0.99) with Four Aces
Seat 3: 1fb9e6f8 showed [Ts 8s] and lost with Pair of Aces and Pair of Eights
Seat 4: 3989b5f1 folded on the Turn
Seat 5: 68bed66e (button) folded before Flop (didn't bet)


Poker Hand #HD50930115: Hold'em No Limit ($0.01/$0.02) - 2024/05/21 19:57:26
Table 'NLHYellow5' 6-max Seat #4 is the button
Seat 1: Hero ($5.71 in chips)
Seat 2: fcaa871e ($2.07 in chips)
Seat 3: 1fb9e6f8 ($0.32 in chips)
Seat 4: 3989b5f1 ($2.65 in chips)
Seat 5: 68bed66e ($1.83 in chips)
68bed66e: posts small blind $0.01
Hero: posts big blind $0.02
*** HOLE CARDS ***
Dealt to Hero [8d Js]
Dealt to fcaa871e 
Dealt to 1fb9e6f8 
Dealt to 3989b5f1 
Dealt to 68bed66e 
fcaa871e: folds
1fb9e6f8: raises $0.02 to $0.04
3989b5f1: folds
68bed66e: folds
Hero: folds
Uncalled bet ($0.02) returned to 1fb9e6f8
*** SHOWDOWN ***
1fb9e6f8 collected $0.05 from pot
*** SUMMARY ***
Total pot $0.05 | Rake $0 | Jackpot $0 | Bingo $0 | Fortune $0 | Tax $0
Seat 1: Hero (big blind) folded before Flop
Seat 2: fcaa871e folded before Flop (didn't bet)
Seat 3: 1fb9e6f8 collected ($0.05)
Seat 4: 3989b5f1 (button) folded before Flop (didn't bet)
Seat 5: 68bed66e (small blind) folded before Flop


Poker Hand #HD50930099: Hold'em No Limit ($0.01/$0.02) - 2024/05/21 19:56:51
Table 'NLHYellow5' 6-max Seat #3 is the button
Seat 1: Hero ($5.71 in chips)
Seat 2: fcaa871e ($2.07 in chips)
Seat 3: 1fb9e6f8 ($0.25 in chips)
Seat 4: 3989b5f1 ($2.66 in chips)
Seat 5: 68bed66e ($1.89 in chips)
3989b5f1: posts small blind $0.01
68bed66e: posts big blind $0.02
*** HOLE CARDS ***
Dealt to Hero [4h Jd]
Dealt to fcaa871e 
Dealt to 1fb9e6f8 
Dealt to 3989b5f1 
Dealt to 68bed66e 
Hero: folds
fcaa871e: folds
1fb9e6f8: calls $0.02
3989b5f1: folds
68bed66e: raises $0.04 to $0.06
1fb9e6f8: calls $0.04
*** FLOP *** [4s 8d 8s]
68bed66e: checks
1fb9e6f8: bets $0.07
68bed66e: folds
Uncalled bet ($0.07) returned to 1fb9e6f8
*** SHOWDOWN ***
1fb9e6f8 collected $0.13 from pot
*** SUMMARY ***
Total pot $0.13 | Rake $0 | Jackpot $0 | Bingo $0 | Fortune $0 | Tax $0
Board [4s 8d 8s]
Seat 1: Hero folded before Flop (didn't bet)
Seat 2: fcaa871e folded before Flop (didn't bet)
Seat 3: 1fb9e6f8 (button) won ($0.13)
Seat 4: 3989b5f1 (small blind) folded before Flop
Seat 5: 68bed66e (big blind) folded on the Flop


Poker Hand #HD50930080: Hold'em No Limit ($0.01/$0.02) - 2024/05/21 19:56:11
Table 'NLHYellow5' 6-max Seat #2 is the button
Seat 1: Hero ($5.71 in chips)
Seat 2: fcaa871e ($2.07 in chips)
Seat 3: 1fb9e6f8 ($0.27 in chips)
Seat 4: 3989b5f1 ($2.68 in chips)
Seat 5: 68bed66e ($1.85 in chips)
1fb9e6f8: posts small blind $0.01
3989b5f1: posts big blind $0.02
*** HOLE CARDS ***
Dealt to Hero [As 4h]
Dealt to fcaa871e 
Dealt to 1fb9e6f8 
Dealt to 3989b5f1 
Dealt to 68bed66e 
68bed66e: calls $0.02
Hero: folds
fcaa871e: folds
1fb9e6f8: calls $0.01
3989b5f1: checks
*** FLOP *** [3d Qc Js]
1fb9e6f8: checks
3989b5f1: checks
68bed66e: checks
*** TURN *** [3d Qc Js] [8c]
1fb9e6f8: checks
3989b5f1: checks
68bed66e: bets $0.03
1fb9e6f8: folds
3989b5f1: folds
Uncalled bet ($0.03) returned to 68bed66e
*** SHOWDOWN ***
68bed66e collected $0.06 from pot
*** SUMMARY ***
Total pot $0.06 | Rake $0 | Jackpot $0 | Bingo $0 | Fortune $0 | Tax $0
Board [3d Qc Js 8c]
Seat 1: Hero folded before Flop (didn't bet)
Seat 2: fcaa871e (button) folded before Flop (didn't bet)
Seat 3: 1fb9e6f8 (small blind) folded on the Turn
Seat 4: 3989b5f1 (big blind) folded on the Turn
Seat 5: 68bed66e won ($0.06)


Poker Hand #HD50930056: Hold'em No Limit ($0.01/$0.02) - 2024/05/21 19:55:09
Table 'NLHYellow5' 6-max Seat #1 is the button
Seat 1: Hero ($5.71 in chips)
Seat 2: fcaa871e ($1.98 in chips)
Seat 3: 1fb9e6f8 ($0.37 in chips)
Seat 4: 3989b5f1 ($2.68 in chips)
Seat 5: 68bed66e ($1.85 in chips)
fcaa871e: posts small blind $0.01
1fb9e6f8: posts big blind $0.02
*** HOLE CARDS ***
Dealt to Hero [4d Ah]
Dealt to fcaa871e 
Dealt to 1fb9e6f8 
Dealt to 3989b5f1 
Dealt to 68bed66e 
3989b5f1: folds
68bed66e: folds
Hero: folds
fcaa871e: calls $0.01
1fb9e6f8: checks
*** FLOP *** [4c Ac 5h]
fcaa871e: bets $0.02
1fb9e6f8: calls $0.02
*** TURN *** [4c Ac 5h] [6d]
fcaa871e: checks
1fb9e6f8: checks
*** RIVER *** [4c Ac 5h 6d] [8d]
fcaa871e: bets $0.06
1fb9e6f8: calls $0.06
fcaa871e: shows [8c 4h] (Pair of Eights and Pair of Fours)
1fb9e6f8: shows [Ad Kh] (Pair of Aces)
*** SHOWDOWN ***
fcaa871e collected $0.19 from pot
*** SUMMARY ***
Total pot $0.2 | Rake $0.01 | Jackpot $0 | Bingo $0 | Fortune $0 | Tax $0
Board [4c Ac 5h 6d 8d]
Seat 1: Hero (button) folded before Flop (didn't bet)
Seat 2: fcaa871e (small blind) showed [8c 4h] and won ($0.19) with Pair of Eights and Pair of Fours
Seat 3: 1fb9e6f8 (big blind) showed [Ad Kh] and lost with Pair of Aces
Seat 4: 3989b5f1 folded before Flop (didn't bet)
Seat 5: 68bed66e folded before Flop (didn't bet)


Poker Hand #HD50930035: Hold'em No Limit ($0.01/$0.02) - 2024/05/21 19:54:25
Table 'NLHYellow5' 6-max Seat #5 is the button
Seat 1: Hero ($5.82 in chips)
Seat 2: fcaa871e ($2 in chips)
Seat 3: 1fb9e6f8 ($0.37 in chips)
Seat 4: 3989b5f1 ($2.73 in chips)
Seat 5: 68bed66e ($1.68 in chips)
Hero: posts small blind $0.01
fcaa871e: posts big blind $0.02
*** HOLE CARDS ***
Dealt to Hero [4d 4s]
Dealt to fcaa871e 
Dealt to 1fb9e6f8 
Dealt to 3989b5f1 
Dealt to 68bed66e 
1fb9e6f8: folds
3989b5f1: raises $0.03 to $0.05
68bed66e: calls $0.05
Hero: calls $0.04
fcaa871e: folds
*** FLOP *** [Qh 6s Ks]
Hero: checks
3989b5f1: checks
68bed66e: checks
*** TURN *** [Qh 6s Ks] [Qs]
Hero: checks
3989b5f1: checks
68bed66e: bets $0.06
Hero: calls $0.06
3989b5f1: folds
*** RIVER *** [Qh 6s Ks Qs] [7h]
Hero: checks
68bed66e: checks
Hero: shows [4d 4s] (Pair of Queens and Pair of Fours)
68bed66e: shows [7c Jd] (Pair of Queens and Pair of Sevens)
*** SHOWDOWN ***
68bed66e collected $0.28 from pot
*** SUMMARY ***
Total pot $0.29 | Rake $0.01 | Jackpot $0 | Bingo $0 | Fortune $0 | Tax $0
Board [Qh 6s Ks Qs 7h]
Seat 1: Hero (small blind) showed [4d 4s] and lost with Pair of Queens and Pair of Fours
Seat 2: fcaa871e (big blind) folded before Flop
Seat 3: 1fb9e6f8 folded before Flop (didn't bet)
Seat 4: 3989b5f1 folded on the Turn
Seat 5: 68bed66e (button) showed [7c Jd] and won ($0.28) with Pair of Queens and Pair of Sevens


Poker Hand #HD50930018: Hold'em No Limit ($0.01/$0.02) - 2024/05/21 19:53:50
Table 'NLHYellow5' 6-max Seat #4 is the button
Seat 1: Hero ($5.78 in chips)
Seat 2: fcaa871e ($2 in chips)
Seat 3: 1fb9e6f8 ($0.37 in chips)
Seat 4: 3989b5f1 ($2.73 in chips)
Seat 5: 68bed66e ($1.72 in chips)
68bed66e: posts small blind $0.01
Hero: posts big blind $0.02
*** HOLE CARDS ***
Dealt to Hero [2s 9s]
Dealt to fcaa871e 
Dealt to 1fb9e6f8 
Dealt to 3989b5f1 
Dealt to 68bed66e 
fcaa871e: folds
1fb9e6f8: folds
3989b5f1: folds
68bed66e: calls $0.01
Hero: checks
*** FLOP *** [7s 5d 2d]
68bed66e: bets $0.02
Hero: raises $0.02 to $0.04
68bed66e: folds
Uncalled bet ($0.02) returned to Hero
*** SHOWDOWN ***
Hero collected $0.08 from pot
*** SUMMARY ***
Total pot $0.08 | Rake $0 | Jackpot $0 | Bingo $0 | Fortune $0 | Tax $0
Board [7s 5d 2d]
Seat 1: Hero (big blind) won ($0.08)
Seat 2: fcaa871e folded before Flop (didn't bet)
Seat 3: 1fb9e6f8 folded before Flop (didn't bet)
Seat 4: 3989b5f1 (button) folded before Flop (didn't bet)
Seat 5: 68bed66e (small blind) folded on the Flop


Poker Hand #HD50899998: Hold'em No Limit ($0.01/$0.02) - 2024/05/21 19:53:07
Table 'NLHYellow5' 6-max Seat #3 is the button
Seat 1: Hero ($5.62 in chips)
Seat 2: fcaa871e ($0.98 in chips)
Seat 3: 1fb9e6f8 ($0.37 in chips)
Seat 4: 3989b5f1 ($2.74 in chips)
Seat 5: 68bed66e ($1.88 in chips)
3989b5f1: posts small blind $0.01
68bed66e: posts big blind $0.02
*** HOLE CARDS ***
Dealt to Hero [Kh Qc]
Dealt to fcaa871e 
Dealt to 1fb9e6f8 
Dealt to 3989b5f1 
Dealt to 68bed66e 
Hero: raises $0.03 to $0.05
fcaa871e: folds
1fb9e6f8: folds
3989b5f1: folds
68bed66e: calls $0.03
*** FLOP *** [Jh 8c Qd]
68bed66e: checks
Hero: bets $0.04
68bed66e: calls $0.04
*** TURN *** [Jh 8c Qd] [As]
68bed66e: checks
Hero: checks
*** RIVER *** [Jh 8c Qd As] [4h]
68bed66e: bets $0.07
Hero: calls $0.07
68bed66e: shows [3s Jd] (Pair of Jacks)
Hero: shows [Kh Qc] (Pair of Queens)
*** SHOWDOWN ***
Hero collected $0.32 from pot
*** SUMMARY ***
Total pot $0.33 | Rake $0.01 | Jackpot $0 | Bingo $0 | Fortune $0 | Tax $0
Board [Jh 8c Qd As 4h]
Seat 1: Hero showed [Kh Qc] and won ($0.32) with Pair of Queens
Seat 2: fcaa871e folded before Flop (didn't bet)
Seat 3: 1fb9e6f8 (button) folded before Flop (didn't bet)
Seat 4: 3989b5f1 (small blind) folded before Flop
Seat 5: 68bed66e (big blind) showed [3s Jd] and lost with Pair of Jacks


Poker Hand #HD50899975: Hold'em No Limit ($0.01/$0.02) - 2024/05/21 19:52:09
Table 'NLHYellow5' 6-max Seat #2 is the button
Seat 1: Hero ($5.28 in chips)
Seat 2: fcaa871e ($1.32 in chips)
Seat 3: 1fb9e6f8 ($0.38 in chips)
Seat 4: 3989b5f1 ($2.76 in chips)
Seat 5: 68bed66e ($1.9 in chips)
1fb9e6f8: posts small blind $0.01
3989b5f1: posts big blind $0.02
*** HOLE CARDS ***
Dealt to Hero [Th Td]
Dealt to fcaa871e 
Dealt to 1fb9e6f8 
Dealt to 3989b5f1 
Dealt to 68bed66e 
68bed66e: calls $0.02
Hero: raises $0.06 to $0.08
fcaa871e: raises $0.11 to $0.19
1fb9e6f8: folds
3989b5f1: folds
68bed66e: folds
Hero: calls $0.11
*** FLOP *** [6h 9c Kd]
Hero: checks
fcaa871e: checks
*** TURN *** [6h 9c Kd] [Jd]
Hero: checks
fcaa871e: checks
*** RIVER *** [6h 9c Kd Jd] [3d]
Hero: bets $0.15
fcaa871e: calls $0.15
Hero: shows [Th Td] (Pair of Tens)
fcaa871e: shows [8c 8d] (Pair of Eights)
*** SHOWDOWN ***
Hero collected $0.68 from pot
*** SUMMARY ***
Total pot $0.73 | Rake $0.03 | Jackpot $0.02 | Bingo $0 | Fortune $0 | Tax $0
Board [6h 9c Kd Jd 3d]
Seat 1: Hero showed [Th Td] and won ($0.68) with Pair of Tens
Seat 2: fcaa871e (button) showed [8c 8d] and lost with Pair of Eights
Seat 3: 1fb9e6f8 (small blind) folded before Flop
Seat 4: 3989b5f1 (big blind) folded before Flop
Seat 5: 68bed66e folded before Flop


Poker Hand #HD50899951: Hold'em No Limit ($0.01/$0.02) - 2024/05/21 19:51:05
Table 'NLHYellow5' 6-max Seat #1 is the button
Seat 1: Hero ($5.28 in chips)
Seat 2: fcaa871e ($1.4 in chips)
Seat 3: 1fb9e6f8 ($0.4 in chips)
Seat 4: 3989b5f1 ($2.76 in chips)
Seat 5: 68bed66e ($1.8 in chips)
fcaa871e: posts small blind $0.01
1fb9e6f8: posts big blind $0.02
*** HOLE CARDS ***
Dealt to Hero [Ad 3h]
Dealt to fcaa871e 
Dealt to 1fb9e6f8 
Dealt to 3989b5f1 
Dealt to 68bed66e 
3989b5f1: folds
68bed66e: calls $0.02
Hero: folds
fcaa871e: calls $0.01
1fb9e6f8: checks
*** FLOP *** [Qs 8s 2h]
fcaa871e: checks
1fb9e6f8: checks
68bed66e: bets $0.06
fcaa871e: calls $0.06
1fb9e6f8: folds
*** TURN *** [Qs 8s 2h] [6s]
fcaa871e: checks
68bed66e: checks
*** RIVER *** [Qs 8s 2h 6s] [5c]
fcaa871e: checks
68bed66e: bets $0.09
fcaa871e: folds
Uncalled bet ($0.09) returned to 68bed66e
*** SHOWDOWN ***
68bed66e collected $0.18 from pot
*** SUMMARY ***
Total pot $0.18 | Rake $0 | Jackpot $0 | Bingo $0 | Fortune $0 | Tax $0
Board [Qs 8s 2h 6s 5c]
Seat 1: Hero (button) folded before Flop (didn't bet)
Seat 2: fcaa871e (small blind) folded on the River
Seat 3: 1fb9e6f8 (big blind) folded on the Flop
Seat 4: 3989b5f1 folded before Flop (didn't bet)
Seat 5: 68bed66e won ($0.18)


Poker Hand #HD50899936: Hold'em No Limit ($0.01/$0.02) - 2024/05/21 19:50:32
Table 'NLHYellow5' 6-max Seat #5 is the button
Seat 1: Hero ($5.29 in chips)
Seat 2: fcaa871e ($1.42 in chips)
Seat 3: 1fb9e6f8 ($0.4 in chips)
Seat 4: 3989b5f1 ($2.76 in chips)
Seat 5: 68bed66e ($1.77 in chips)
Hero: posts small blind $0.01
fcaa871e: posts big blind $0.02
*** HOLE CARDS ***
Dealt to Hero [4h 9s]
Dealt to fcaa871e 
Dealt to 1fb9e6f8 
Dealt to 3989b5f1 
Dealt to 68bed66e 
1fb9e6f8: folds
3989b5f1: folds
68bed66e: calls $0.02
Hero: folds
fcaa871e: checks
*** FLOP *** [Th Kh Td]
fcaa871e: checks
68bed66e: checks
*** TURN *** [Th Kh Td] [Tc]
fcaa871e: checks
68bed66e: bets $0.03
fcaa871e: folds
Uncalled bet ($0.03) returned to 68bed66e
*** SHOWDOWN ***
68bed66e collected $0.05 from pot
*** SUMMARY ***
Total pot $0.05 | Rake $0 | Jackpot $0 | Bingo $0 | Fortune $0 | Tax $0
Board [Th Kh Td Tc]
Seat 1: Hero (small blind) folded before Flop
Seat 2: fcaa871e (big blind) folded on the Turn
Seat 3: 1fb9e6f8 folded before Flop (didn't bet)
Seat 4: 3989b5f1 folded before Flop (didn't bet)
Seat 5: 68bed66e (button) won ($0.05)


Poker Hand #HD50899912: Hold'em No Limit ($0.01/$0.02) - 2024/05/21 19:49:34
Table 'NLHYellow5' 6-max Seat #4 is the button
Seat 1: Hero ($5.34 in chips)
Seat 2: fcaa871e ($1.42 in chips)
Seat 3: 1fb9e6f8 ($0.45 in chips)
Seat 4: 3989b5f1 ($2.76 in chips)
Seat 5: 68bed66e ($1.67 in chips)
68bed66e: posts small blind $0.01
Hero: posts big blind $0.02
*** HOLE CARDS ***
Dealt to Hero [6s 6h]
Dealt to fcaa871e 
Dealt to 1fb9e6f8 
Dealt to 3989b5f1 
Dealt to 68bed66e 
fcaa871e: folds
1fb9e6f8: calls $0.02
3989b5f1: folds
68bed66e: calls $0.01
Hero: checks
*** FLOP *** [3d Tc 7d]
68bed66e: checks
Hero: checks
1fb9e6f8: checks
*** TURN *** [3d Tc 7d] [9c]
68bed66e: bets $0.03
Hero: calls $0.03
1fb9e6f8: calls $0.03
*** RIVER *** [3d Tc 7d 9c] [Jh]
68bed66e: checks
Hero: checks
1fb9e6f8: checks
68bed66e: shows [9d 5c] (Pair of Nines)
Hero: shows [6s 6h] (Pair of Sixes)
1fb9e6f8: shows [7s Ac] (Pair of Sevens)
*** SHOWDOWN ***
68bed66e collected $0.15 from pot
*** SUMMARY ***
Total pot $0.15 | Rake $0 | Jackpot $0 | Bingo $0 | Fortune $0 | Tax $0
Board [3d Tc 7d 9c Jh]
Seat 1: Hero (big blind) showed [6s 6h] and lost with Pair of Sixes
Seat 2: fcaa871e folded before Flop (didn't bet)
Seat 3: 1fb9e6f8 showed [7s Ac] and lost with Pair of Sevens
Seat 4: 3989b5f1 (button) folded before Flop (didn't bet)
Seat 5: 68bed66e (small blind) showed [9d 5c] and won ($0.15) with Pair of Nines


Poker Hand #HD50899899: Hold'em No Limit ($0.01/$0.02) - 2024/05/21 19:48:50
Table 'NLHYellow5' 6-max Seat #3 is the button
Seat 1: Hero ($5.34 in chips)
Seat 2: fcaa871e ($1.42 in chips)
Seat 3: 1fb9e6f8 ($0.45 in chips)
Seat 4: 3989b5f1 ($2.77 in chips)
Seat 5: 68bed66e ($1 in chips)
Seat 6: 3494b53b ($0.75 in chips)
3989b5f1: posts small blind $0.01
68bed66e: posts big blind $0.02
*** HOLE CARDS ***
Dealt to Hero [Td 5s]
Dealt to fcaa871e 
Dealt to 1fb9e6f8 
Dealt to 3989b5f1 
Dealt to 68bed66e 
Dealt to 3494b53b 
3494b53b: raises $0.06 to $0.08
Hero: folds
fcaa871e: folds
1fb9e6f8: folds
3989b5f1: folds
68bed66e: calls $0.06
*** FLOP *** [9c 2h 4s]
68bed66e: bets $0.09
3494b53b: raises $0.35 to $0.44
68bed66e: calls $0.35
*** TURN *** [9c 2h 4s] [7h]
68bed66e: checks
3494b53b: bets $0.23 and is all-in
68bed66e: calls $0.23
3494b53b: shows [Qc 2c] (Pair of Twos)
68bed66e: shows [Qh Qs] (Pair of Queens)
*** RIVER *** [9c 2h 4s 7h] [As]
*** SHOWDOWN ***
68bed66e collected $1.42 from pot
*** SUMMARY ***
Total pot $1.51 | Rake $0.07 | Jackpot $0.02 | Bingo $0 | Fortune $0 | Tax $0
Board [9c 2h 4s 7h As]
Seat 1: Hero folded before Flop (didn't bet)
Seat 2: fcaa871e folded before Flop (didn't bet)
Seat 3: 1fb9e6f8 (button) folded before Flop (didn't bet)
Seat 4: 3989b5f1 (small blind) folded before Flop
Seat 5: 68bed66e (big blind) showed [Qh Qs] and won ($1.42) with Pair of Queens
Seat 6: 3494b53b showed [Qc 2c] and lost with Pair of Twos


Poker Hand #HD50899888: Hold'em No Limit ($0.01/$0.02) - 2024/05/21 19:48:26
Table 'NLHYellow5' 6-max Seat #2 is the button
Seat 1: Hero ($5.31 in chips)
Seat 2: fcaa871e ($1.42 in chips)
Seat 3: 1fb9e6f8 ($0.46 in chips)
Seat 4: 3989b5f1 ($2.79 in chips)
Seat 6: 3494b53b ($0.75 in chips)
1fb9e6f8: posts small blind $0.01
3989b5f1: posts big blind $0.02
*** HOLE CARDS ***
Dealt to Hero [As Kh]
Dealt to fcaa871e 
Dealt to 1fb9e6f8 
Dealt to 3989b5f1 
Dealt to 3494b53b 
3494b53b: folds
Hero: raises $0.03 to $0.05
fcaa871e: folds
1fb9e6f8: folds
3989b5f1: folds
Uncalled bet ($0.03) returned to Hero
*** SHOWDOWN ***
Hero collected $0.05 from pot
*** SUMMARY ***
Total pot $0.05 | Rake $0 | Jackpot $0 | Bingo $0 | Fortune $0 | Tax $0
Seat 1: Hero collected ($0.05)
Seat 2: fcaa871e (button) folded before Flop (didn't bet)
Seat 3: 1fb9e6f8 (small blind) folded before Flop
Seat 4: 3989b5f1 (big blind) folded before Flop
Seat 6: 3494b53b folded before Flop (didn't bet)


Poker Hand #HD50899876: Hold'em No Limit ($0.01/$0.02) - 2024/05/21 19:47:55
Table 'NLHYellow5' 6-max Seat #1 is the button
Seat 1: Hero ($5.31 in chips)
Seat 2: fcaa871e ($1.4 in chips)
Seat 3: 1fb9e6f8 ($0.48 in chips)
Seat 4: 3989b5f1 ($2.79 in chips)
Seat 6: 3494b53b ($0.75 in chips)
fcaa871e: posts small blind $0.01
1fb9e6f8: posts big blind $0.02
*** HOLE CARDS ***
Dealt to Hero [6d 2s]
Dealt to fcaa871e 
Dealt to 1fb9e6f8 
Dealt to 3989b5f1 
Dealt to 3494b53b 
3989b5f1: folds
3494b53b: folds
Hero: folds
fcaa871e: calls $0.01
1fb9e6f8: checks
*** FLOP *** [3s Kd Qc]
fcaa871e: bets $0.02
1fb9e6f8: folds
Uncalled bet ($0.02) returned to fcaa871e
*** SHOWDOWN ***
fcaa871e collected $0.04 from pot
*** SUMMARY ***
Total pot $0.04 | Rake $0 | Jackpot $0 | Bingo $0 | Fortune $0 | Tax $0
Board [3s Kd Qc]
Seat 1: Hero (button) folded before Flop (didn't bet)
Seat 2: fcaa871e (small blind) won ($0.04)
Seat 3: 1fb9e6f8 (big blind) folded on the Flop
Seat 4: 3989b5f1 folded before Flop (didn't bet)
Seat 6: 3494b53b folded before Flop (didn't bet)


Poker Hand #HD50899871: Hold'em No Limit ($0.01/$0.02) - 2024/05/21 19:47:30
Table 'NLHYellow5' 6-max Seat #6 is the button
Seat 1: Hero ($5.32 in chips)
Seat 2: fcaa871e ($1.42 in chips)
Seat 3: 1fb9e6f8 ($0.5 in chips)
Seat 4: 3989b5f1 ($2.79 in chips)
Seat 6: 3494b53b ($0.7 in chips)
Hero: posts small blind $0.01
fcaa871e: posts big blind $0.02
1fb9e6f8: posts big blind $0.02
*** HOLE CARDS ***
Dealt to Hero [Kh 5d]
Dealt to fcaa871e 
Dealt to 1fb9e6f8 
Dealt to 3989b5f1 
Dealt to 3494b53b 
1fb9e6f8: checks
3989b5f1: folds
3494b53b: raises $0.06 to $0.08
Hero: folds
fcaa871e: folds
1fb9e6f8: folds
Uncalled bet ($0.06) returned to 3494b53b
*** SHOWDOWN ***
3494b53b collected $0.07 from pot
*** SUMMARY ***
Total pot $0.07 | Rake $0 | Jackpot $0 | Bingo $0 | Fortune $0 | Tax $0
Seat 1: Hero (small blind) folded before Flop
Seat 2: fcaa871e (big blind) folded before Flop
Seat 3: 1fb9e6f8 folded before Flop
Seat 4: 3989b5f1 folded before Flop (didn't bet)
Seat 6: 3494b53b (button) collected ($0.07)


Poker Hand #HD50899829: Hold'em No Limit ($0.01/$0.02) - 2024/05/21 19:45:48
Table 'NLHYellow5' 6-max Seat #4 is the button
Seat 1: Hero ($5.44 in chips)
Seat 2: fcaa871e ($1.54 in chips)
Seat 4: 3989b5f1 ($1.92 in chips)
Seat 6: 3494b53b ($1.43 in chips)
3494b53b: posts small blind $0.01
Hero: posts big blind $0.02
*** HOLE CARDS ***
Dealt to Hero [Ts Qd]
Dealt to fcaa871e 
Dealt to 3989b5f1 
Dealt to 3494b53b 
fcaa871e: raises $0.04 to $0.06
3989b5f1: calls $0.06
3494b53b: calls $0.05
Hero: calls $0.04
*** FLOP *** [9s 5d Kh]
3494b53b: checks
Hero: checks
fcaa871e: checks
3989b5f1: bets $0.06
3494b53b: calls $0.06
Hero: calls $0.06
fcaa871e: calls $0.06
*** TURN *** [9s 5d Kh] [Kd]
3494b53b: checks
Hero: checks
fcaa871e: checks
3989b5f1: bets $0.1
3494b53b: calls $0.1
Hero: folds
fcaa871e: folds
*** RIVER *** [9s 5d Kh Kd] [Jh]
3494b53b: checks
3989b5f1: bets $0.51
3494b53b: calls $0.51
3989b5f1: shows [5c 5s] (Fives Full over Kings)
3494b53b: shows [Js 9c] (Pair of Kings and Pair of Jacks)
*** SHOWDOWN ***
3989b5f1 collected $1.6 from pot
*** SUMMARY ***
Total pot $1.7 | Rake $0.08 | Jackpot $0.02 | Bingo $0 | Fortune $0 | Tax $0
Board [9s 5d Kh Kd Jh]
Seat 1: Hero (big blind) folded on the Turn
Seat 2: fcaa871e folded on the Turn
Seat 4: 3989b5f1 (button) showed [5c 5s] and won ($1.6) with Fives Full over Kings
Seat 6: 3494b53b (small blind) showed [Js 9c] and lost with Pair of Kings and Pair of Jacks


Poker Hand #HD50899821: Hold'em No Limit ($0.01/$0.02) - 2024/05/21 19:45:33
Table 'NLHYellow5' 6-max Seat #2 is the button
Seat 1: Hero ($5.44 in chips)
Seat 2: fcaa871e ($1.54 in chips)
Seat 4: 3989b5f1 ($1.93 in chips)
Seat 6: 3494b53b ($1.42 in chips)
3989b5f1: posts small blind $0.01
3494b53b: posts big blind $0.02
*** HOLE CARDS ***
Dealt to Hero [Jd 3c]
Dealt to fcaa871e 
Dealt to 3989b5f1 
Dealt to 3494b53b 
Hero: folds
fcaa871e: folds
3989b5f1: folds
Uncalled bet ($0.01) returned to 3494b53b
*** SHOWDOWN ***
3494b53b collected $0.02 from pot
*** SUMMARY ***
Total pot $0.02 | Rake $0 | Jackpot $0 | Bingo $0 | Fortune $0 | Tax $0
Seat 1: Hero folded before Flop (didn't bet)
Seat 2: fcaa871e (button) folded before Flop (didn't bet)
Seat 4: 3989b5f1 (small blind) folded before Flop
Seat 6: 3494b53b (big blind) collected ($0.02)


Poker Hand #HD50899817: Hold'em No Limit ($0.01/$0.02) - 2024/05/21 19:45:26
Table 'NLHYellow5' 6-max Seat #1 is the button
Seat 1: Hero ($5.44 in chips)
Seat 2: fcaa871e ($1.55 in chips)
Seat 4: 3989b5f1 ($1.92 in chips)
Seat 6: 3494b53b ($1.42 in chips)
fcaa871e: posts small blind $0.01
3989b5f1: posts big blind $0.02
*** HOLE CARDS ***
Dealt to Hero [9c 2h]
Dealt to fcaa871e 
Dealt to 3989b5f1 
Dealt to 3494b53b 
3494b53b: folds
Hero: folds
fcaa871e: folds
Uncalled bet ($0.01) returned to 3989b5f1
*** SHOWDOWN ***
3989b5f1 collected $0.02 from pot
*** SUMMARY ***
Total pot $0.02 | Rake $0 | Jackpot $0 | Bingo $0 | Fortune $0 | Tax $0
Seat 1: Hero (button) folded before Flop (didn't bet)
Seat 2: fcaa871e (small blind) folded before Flop
Seat 4: 3989b5f1 (big blind) collected ($0.02)
Seat 6: 3494b53b folded before Flop (didn't bet)


Poker Hand #HD50899799: Hold'em No Limit ($0.01/$0.02) - 2024/05/21 19:44:41
Table 'NLHYellow5' 6-max Seat #6 is the button
Seat 1: Hero ($5.45 in chips)
Seat 2: fcaa871e ($1.57 in chips)
Seat 4: 3989b5f1 ($1.92 in chips)
Seat 5: f3955548 ($1.54 in chips)
Seat 6: 3494b53b ($0.74 in chips)
Hero: posts small blind $0.01
fcaa871e: posts big blind $0.02
*** HOLE CARDS ***
Dealt to Hero [8c 9s]
Dealt to fcaa871e 
Dealt to 3989b5f1 
Dealt to f3955548 
Dealt to 3494b53b 
3989b5f1: folds
f3955548: raises $0.08 to $0.1
3494b53b: raises $0.17 to $0.27
Hero: folds
fcaa871e: folds
f3955548: raises $1.27 to $1.54 and is all-in
3494b53b: calls $0.47 and is all-in
Uncalled bet ($0.8) returned to f3955548
f3955548: shows [3h 6h]
3494b53b: shows [9d Jh]
*** FLOP *** [Ad 3c Js]
*** TURN *** [Ad 3c Js] [Qh]
*** RIVER *** [Ad 3c Js Qh] [Jc]
*** SHOWDOWN ***
3494b53b collected $1.42 from pot
*** SUMMARY ***
Total pot $1.51 | Rake $0.07 | Jackpot $0.02 | Bingo $0 | Fortune $0 | Tax $0
Board [Ad 3c Js Qh Jc]
Seat 1: Hero (small blind) folded before Flop
Seat 2: fcaa871e (big blind) folded before Flop
Seat 4: 3989b5f1 folded before Flop (didn't bet)
Seat 5: f3955548 showed [3h 6h] and lost with Pair of Jacks and Pair of Treys
Seat 6: 3494b53b (button) showed [9d Jh] and won ($1.42) with Three Jacks


Poker Hand #HD50899778: Hold'em No Limit ($0.01/$0.02) - 2024/05/21 19:43:48
Table 'NLHYellow5' 6-max Seat #5 is the button
Seat 1: Hero ($5.38 in chips)
Seat 2: fcaa871e ($1.63 in chips)
Seat 4: 3989b5f1 ($1.92 in chips)
Seat 5: f3955548 ($1.54 in chips)
Seat 6: 3494b53b ($0.75 in chips)
3494b53b: posts small blind $0.01
Hero: posts big blind $0.02
*** HOLE CARDS ***
Dealt to Hero [Ts Qh]
Dealt to fcaa871e 
Dealt to 3989b5f1 
Dealt to f3955548 
Dealt to 3494b53b 
fcaa871e: raises $0.04 to $0.06
3989b5f1: folds
f3955548: folds
3494b53b: folds
Hero: calls $0.04
*** FLOP *** [2h Ac 5h]
Hero: checks
fcaa871e: checks
*** TURN *** [2h Ac 5h] [3s]
Hero: bets $0.05
fcaa871e: folds
Uncalled bet ($0.05) returned to Hero
*** SHOWDOWN ***
Hero collected $0.13 from pot
*** SUMMARY ***
Total pot $0.13 | Rake $0 | Jackpot $0 | Bingo $0 | Fortune $0 | Tax $0
Board [2h Ac 5h 3s]
Seat 1: Hero (big blind) won ($0.13)
Seat 2: fcaa871e folded on the Turn
Seat 4: 3989b5f1 folded before Flop (didn't bet)
Seat 5: f3955548 (button) folded before Flop (didn't bet)
Seat 6: 3494b53b (small blind) folded before Flop


Poker Hand #HD50899747: Hold'em No Limit ($0.01/$0.02) - 2024/05/21 19:42:44
Table 'NLHYellow5' 6-max Seat #4 is the button
Seat 1: Hero ($5.3 in chips)
Seat 2: fcaa871e ($1.68 in chips)
Seat 4: 3989b5f1 ($1.92 in chips)
Seat 5: f3955548 ($1.55 in chips)
Seat 6: 3494b53b ($0.77 in chips)
f3955548: posts small blind $0.01
3494b53b: posts big blind $0.02
*** HOLE CARDS ***
Dealt to Hero [6c As]
Dealt to fcaa871e 
Dealt to 3989b5f1 
Dealt to f3955548 
Dealt to 3494b53b 
Hero: calls $0.02
fcaa871e: calls $0.02
3989b5f1: folds
f3955548: folds
3494b53b: checks
*** FLOP *** [Js 6h Ac]
3494b53b: checks
Hero: bets $0.03
fcaa871e: calls $0.03
3494b53b: folds
*** TURN *** [Js 6h Ac] [4s]
Hero: bets $0.1
fcaa871e: folds
Uncalled bet ($0.1) returned to Hero
*** SHOWDOWN ***
Hero collected $0.13 from pot
*** SUMMARY ***
Total pot $0.13 | Rake $0 | Jackpot $0 | Bingo $0 | Fortune $0 | Tax $0
Board [Js 6h Ac 4s]
Seat 1: Hero won ($0.13)
Seat 2: fcaa871e folded on the Turn
Seat 4: 3989b5f1 (button) folded before Flop (didn't bet)
Seat 5: f3955548 (small blind) folded before Flop
Seat 6: 3494b53b (big blind) folded on the Flop


Poker Hand #HD50899738: Hold'em No Limit ($0.01/$0.02) - 2024/05/21 19:42:24
Table 'NLHYellow5' 6-max Seat #2 is the button
Seat 1: Hero ($5.3 in chips)
Seat 2: fcaa871e ($1.65 in chips)
Seat 4: 3989b5f1 ($1.93 in chips)
Seat 5: f3955548 ($1.57 in chips)
Seat 6: 3494b53b ($0.77 in chips)
3989b5f1: posts small blind $0.01
f3955548: posts big blind $0.02
*** HOLE CARDS ***
Dealt to Hero [2h 4s]
Dealt to fcaa871e 
Dealt to 3989b5f1 
Dealt to f3955548 
Dealt to 3494b53b 
3494b53b: folds
Hero: folds
fcaa871e: raises $0.04 to $0.06
3989b5f1: folds
f3955548: folds
Uncalled bet ($0.04) returned to fcaa871e
*** SHOWDOWN ***
fcaa871e collected $0.05 from pot
*** SUMMARY ***
Total pot $0.05 | Rake $0 | Jackpot $0 | Bingo $0 | Fortune $0 | Tax $0
Seat 1: Hero folded before Flop (didn't bet)
Seat 2: fcaa871e (button) collected ($0.05)
Seat 4: 3989b5f1 (small blind) folded before Flop
Seat 5: f3955548 (big blind) folded before Flop
Seat 6: 3494b53b folded before Flop (didn't bet)


Poker Hand #HD50899706: Hold'em No Limit ($0.01/$0.02) - 2024/05/21 19:40:45
Table 'NLHYellow5' 6-max Seat #1 is the button
Seat 1: Hero ($5.11 in chips)
Seat 2: fcaa871e ($1.66 in chips)
Seat 3: e5b1b65f ($1.94 in chips)
Seat 4: 3989b5f1 ($1.93 in chips)
Seat 5: f3955548 ($1.57 in chips)
Seat 6: 3494b53b ($0.95 in chips)
fcaa871e: posts small blind $0.01
e5b1b65f: posts big blind $0.02
3494b53b: posts big blind $0.02
*** HOLE CARDS ***
Dealt to Hero [Kc Ah]
Dealt to fcaa871e 
Dealt to e5b1b65f 
Dealt to 3989b5f1 
Dealt to f3955548 
Dealt to 3494b53b 
3989b5f1: folds
f3955548: folds
3494b53b: raises $0.04 to $0.06
Hero: raises $0.12 to $0.18
fcaa871e: folds
e5b1b65f: folds
3494b53b: calls $0.12
*** FLOP *** [As 8s 5s]
3494b53b: checks
Hero: bets $0.13
3494b53b: folds
Uncalled bet ($0.13) returned to Hero
*** SHOWDOWN ***
Hero collected $0.37 from pot
*** SUMMARY ***
Total pot $0.39 | Rake $0.02 | Jackpot $0 | Bingo $0 | Fortune $0 | Tax $0
Board [As 8s 5s]
Seat 1: Hero (button) won ($0.37)
Seat 2: fcaa871e (small blind) folded before Flop
Seat 3: e5b1b65f (big blind) folded before Flop
Seat 4: 3989b5f1 folded before Flop (didn't bet)
Seat 5: f3955548 folded before Flop (didn't bet)
Seat 6: 3494b53b folded on the Flop


Poker Hand #HD50899659: Hold'em No Limit ($0.01/$0.02) - 2024/05/21 19:39:10
Table 'NLHYellow5' 6-max Seat #5 is the button
Seat 1: Hero ($5.12 in chips)
Seat 2: fcaa871e ($1.41 in chips)
Seat 3: e5b1b65f ($2 in chips)
Seat 4: 3989b5f1 ($1.93 in chips)
Seat 5: f3955548 ($1.77 in chips)
Hero: posts small blind $0.01
fcaa871e: posts big blind $0.02
e5b1b65f: posts big blind $0.02
*** HOLE CARDS ***
Dealt to Hero [Kd Js]
Dealt to fcaa871e 
Dealt to e5b1b65f 
Dealt to 3989b5f1 
Dealt to f3955548 
e5b1b65f: raises $0.04 to $0.06
3989b5f1: folds
f3955548: raises $0.14 to $0.2
Hero: folds
fcaa871e: calls $0.18
e5b1b65f: folds
*** FLOP *** [7c 9s 4s]
fcaa871e: checks
f3955548: checks
*** TURN *** [7c 9s 4s] [Kh]
fcaa871e: checks
f3955548: checks
*** RIVER *** [7c 9s 4s Kh] [9h]
fcaa871e: bets $0.16
f3955548: folds
Uncalled bet ($0.16) returned to fcaa871e
*** SHOWDOWN ***
fcaa871e collected $0.45 from pot
*** SUMMARY ***
Total pot $0.47 | Rake $0.02 | Jackpot $0 | Bingo $0 | Fortune $0 | Tax $0
Board [7c 9s 4s Kh 9h]
Seat 1: Hero (small blind) folded before Flop
Seat 2: fcaa871e (big blind) won ($0.45)
Seat 3: e5b1b65f folded before Flop
Seat 4: 3989b5f1 folded before Flop (didn't bet)
Seat 5: f3955548 (button) folded on the River


Poker Hand #HD50899630: Hold'em No Limit ($0.01/$0.02) - 2024/05/21 19:38:03
Table 'NLHYellow5' 6-max Seat #4 is the button
Seat 1: Hero ($5.23 in chips)
Seat 2: fcaa871e ($1.3 in chips)
Seat 4: 3989b5f1 ($1.93 in chips)
Seat 5: f3955548 ($1.78 in chips)
f3955548: posts small blind $0.01
Hero: posts big blind $0.02
*** HOLE CARDS ***
Dealt to Hero [5h Jh]
Dealt to fcaa871e 
Dealt to 3989b5f1 
Dealt to f3955548 
fcaa871e: calls $0.02
3989b5f1: folds
f3955548: folds
Hero: checks
*** FLOP *** [5s 9h 2h]
Hero: bets $0.02
fcaa871e: calls $0.02
*** TURN *** [5s 9h 2h] [Qs]
Hero: bets $0.07
fcaa871e: calls $0.07
*** RIVER *** [5s 9h 2h Qs] [6d]
Hero: checks
fcaa871e: checks
Hero: shows [5h Jh] (Pair of Fives)
fcaa871e: shows [As 6c] (Pair of Sixes)
*** SHOWDOWN ***
fcaa871e collected $0.22 from pot
*** SUMMARY ***
Total pot $0.23 | Rake $0.01 | Jackpot $0 | Bingo $0 | Fortune $0 | Tax $0
Board [5s 9h 2h Qs 6d]
Seat 1: Hero (big blind) showed [5h Jh] and lost with Pair of Fives
Seat 2: fcaa871e showed [As 6c] and won ($0.22) with Pair of Sixes
Seat 4: 3989b5f1 (button) folded before Flop (didn't bet)
Seat 5: f3955548 (small blind) folded before Flop


Poker Hand #HD50899610: Hold'em No Limit ($0.01/$0.02) - 2024/05/21 19:37:15
Table 'NLHYellow5' 6-max Seat #2 is the button
Seat 1: Hero ($5.23 in chips)
Seat 2: fcaa871e ($1.36 in chips)
Seat 4: 3989b5f1 ($1.94 in chips)
Seat 5: f3955548 ($1.24 in chips)
Seat 6: 15c9222b ($0.54 in chips)
3989b5f1: posts small blind $0.01
f3955548: posts big blind $0.02
*** HOLE CARDS ***
Dealt to Hero [6c 8d]
Dealt to fcaa871e 
Dealt to 3989b5f1 
Dealt to f3955548 
Dealt to 15c9222b 
15c9222b: calls $0.02
Hero: folds
fcaa871e: raises $0.04 to $0.06
3989b5f1: folds
f3955548: raises $0.08 to $0.14
15c9222b: raises $0.4 to $0.54 and is all-in
fcaa871e: folds
f3955548: calls $0.4
15c9222b: shows [Ac Ts]
f3955548: shows [7d 7c]
*** FLOP *** [5c 2s Kh]
*** TURN *** [5c 2s Kh] [3d]
*** RIVER *** [5c 2s Kh 3d] [2c]
3989b5f1: shows [7s] (Pair of Twos)
*** SHOWDOWN ***
f3955548 collected $1.08 from pot
*** SUMMARY ***
Total pot $1.15 | Rake $0.05 | Jackpot $0.02 | Bingo $0 | Fortune $0 | Tax $0
Board [5c 2s Kh 3d 2c]
Seat 1: Hero folded before Flop (didn't bet)
Seat 2: fcaa871e (button) folded before Flop
Seat 4: 3989b5f1 (small blind) folded before Flop
Seat 5: f3955548 (big blind) showed [7d 7c] and won ($1.08) with Pair of Sevens and Pair of Twos
Seat 6: 15c9222b showed [Ac Ts] and lost with Pair of Twos


Poker Hand #HD50899582: Hold'em No Limit ($0.01/$0.02) - 2024/05/21 19:35:48
Table 'NLHYellow5' 6-max Seat #1 is the button
Seat 1: Hero ($5.29 in chips)
Seat 2: fcaa871e ($1.98 in chips)
Seat 3: 9c4b3ea8 ($2.29 in chips)
Seat 4: 3989b5f1 ($1.94 in chips)
Seat 5: f3955548 ($0.62 in chips)
Seat 6: 15c9222b ($0.54 in chips)
fcaa871e: posts small blind $0.01
9c4b3ea8: posts big blind $0.02
*** HOLE CARDS ***
Dealt to Hero [Ts Ks]
Dealt to fcaa871e 
Dealt to 9c4b3ea8 
Dealt to 3989b5f1 
Dealt to f3955548 
Dealt to 15c9222b 
3989b5f1: folds
f3955548: raises $0.04 to $0.06
15c9222b: folds
Hero: calls $0.06
fcaa871e: calls $0.05
9c4b3ea8: folds
*** FLOP *** [6c 9h Ah]
fcaa871e: bets $0.1
f3955548: raises $0.46 to $0.56 and is all-in
Hero: folds
fcaa871e: calls $0.46
f3955548: shows [Ad Qc] (Pair of Aces)
fcaa871e: shows [Kc Kh] (Pair of Kings)
*** TURN *** [6c 9h Ah] [4c]
*** RIVER *** [6c 9h Ah 4c] [2s]
*** SHOWDOWN ***
f3955548 collected $1.24 from pot
*** SUMMARY ***
Total pot $1.32 | Rake $0.06 | Jackpot $0.02 | Bingo $0 | Fortune $0 | Tax $0
Board [6c 9h Ah 4c 2s]
Seat 1: Hero (button) folded on the Flop
Seat 2: fcaa871e (small blind) showed [Kc Kh] and lost with Pair of Kings
Seat 3: 9c4b3ea8 (big blind) folded before Flop
Seat 4: 3989b5f1 folded before Flop (didn't bet)
Seat 5: f3955548 showed [Ad Qc] and won ($1.24) with Pair of Aces
Seat 6: 15c9222b folded before Flop (didn't bet)


Poker Hand #HD50899578: Hold'em No Limit ($0.01/$0.02) - 2024/05/21 19:35:32
Table 'NLHYellow5' 6-max Seat #6 is the button
Seat 1: Hero ($5.3 in chips)
Seat 2: fcaa871e ($2 in chips)
Seat 4: 3989b5f1 ($1.94 in chips)
Seat 5: f3955548 ($0.62 in chips)
Seat 6: 15c9222b ($0.51 in chips)
Hero: posts small blind $0.01
fcaa871e: posts big blind $0.02
*** HOLE CARDS ***
Dealt to Hero [Td 9d]
Dealt to fcaa871e 
Dealt to 3989b5f1 
Dealt to f3955548 
Dealt to 15c9222b 
3989b5f1: folds
f3955548: folds
15c9222b: raises $0.49 to $0.51 and is all-in
Hero: folds
fcaa871e: folds
Uncalled bet ($0.49) returned to 15c9222b
*** SHOWDOWN ***
15c9222b collected $0.05 from pot
*** SUMMARY ***
Total pot $0.05 | Rake $0 | Jackpot $0 | Bingo $0 | Fortune $0 | Tax $0
Seat 1: Hero (small blind) folded before Flop
Seat 2: fcaa871e (big blind) folded before Flop
Seat 4: 3989b5f1 folded before Flop (didn't bet)
Seat 5: f3955548 folded before Flop (didn't bet)
Seat 6: 15c9222b (button) collected ($0.05)


Poker Hand #HD50899572: Hold'em No Limit ($0.01/$0.02) - 2024/05/21 19:35:12
Table 'NLHYellow5' 6-max Seat #5 is the button
Seat 1: Hero ($5.32 in chips)
Seat 4: 3989b5f1 ($1.94 in chips)
Seat 5: f3955548 ($0.62 in chips)
Seat 6: 15c9222b ($0.49 in chips)
15c9222b: posts small blind $0.01
Hero: posts big blind $0.02
*** HOLE CARDS ***
Dealt to Hero [5d Qc]
Dealt to 3989b5f1 
Dealt to f3955548 
Dealt to 15c9222b 
3989b5f1: folds
f3955548: folds
15c9222b: calls $0.01
Hero: checks
*** FLOP *** [4h 7h Qs]
15c9222b: bets $0.47 and is all-in
Hero: folds
Uncalled bet ($0.47) returned to 15c9222b
*** SHOWDOWN ***
15c9222b collected $0.04 from pot
*** SUMMARY ***
Total pot $0.04 | Rake $0 | Jackpot $0 | Bingo $0 | Fortune $0 | Tax $0
Board [4h 7h Qs]
Seat 1: Hero (big blind) folded on the Flop
Seat 4: 3989b5f1 folded before Flop (didn't bet)
Seat 5: f3955548 (button) folded before Flop (didn't bet)
Seat 6: 15c9222b (small blind) won ($0.04)


Poker Hand #HD50899549: Hold'em No Limit ($0.01/$0.02) - 2024/05/21 19:34:24
Table 'NLHYellow5' 6-max Seat #4 is the button
Seat 1: Hero ($5.32 in chips)
Seat 4: 3989b5f1 ($1.94 in chips)
Seat 5: f3955548 ($0.49 in chips)
Seat 6: 15c9222b ($0.67 in chips)
f3955548: posts small blind $0.01
15c9222b: posts big blind $0.02
*** HOLE CARDS ***
Dealt to Hero [Qd 4h]
Dealt to 3989b5f1 
Dealt to f3955548 
Dealt to 15c9222b 
Hero: folds
3989b5f1: folds
f3955548: raises $0.06 to $0.08
15c9222b: calls $0.06
*** FLOP *** [Jh 9h 8h]
f3955548: bets $0.41 and is all-in
15c9222b: calls $0.41
f3955548: shows [Kc Js] (Pair of Jacks)
15c9222b: shows [Qh 7s] (Queen-High)
*** FIRST TURN *** [Jh 9h 8h] [8s]
*** FIRST RIVER *** [Jh 9h 8h 8s] [Kd]
*** SECOND TURN *** [Jh 9h 8h] [7d]
*** SECOND RIVER *** [Jh 9h 8h 7d] [Ts]
*** THIRD TURN *** [Jh 9h 8h] [6s]
*** THIRD RIVER *** [Jh 9h 8h 6s] [8c]
*** FIRST SHOWDOWN ***
f3955548 collected $0.31 from pot
*** SECOND SHOWDOWN ***
15c9222b collected $0.31 from pot
*** THIRD SHOWDOWN ***
f3955548 collected $0.31 from pot
*** SUMMARY ***
Total pot $0.98 | Rake $0.03 | Jackpot $0.02 | Bingo $0 | Fortune $0 | Tax $0
Hand was run three times
FIRST Board [Jh 9h 8h 8s Kd]
SECOND Board [7d Ts]
THIRD Board [6s 8c]
Seat 1: Hero folded before Flop (didn't bet)
Seat 4: 3989b5f1 (button) folded before Flop (didn't bet)
Seat 5: f3955548 (small blind) showed [Kc Js] and won ($0.31) with Pair of Kings and Pair of Jacks, and lost, and won ($0.31)
Seat 6: 15c9222b (big blind) showed [Qh 7s] and lost with Pair of Eights, and won ($0.31), and lost


Poker Hand #HD50899536: Hold'em No Limit ($0.01/$0.02) - 2024/05/21 19:33:43
Table 'NLHYellow5' 6-max Seat #1 is the button
Seat 1: Hero ($5.32 in chips)
Seat 4: 3989b5f1 ($1.95 in chips)
Seat 5: f3955548 ($0.99 in chips)
Seat 6: 15c9222b ($0.5 in chips)
3989b5f1: posts small blind $0.01
f3955548: posts big blind $0.02
15c9222b: posts big blind $0.02
*** HOLE CARDS ***
Dealt to Hero [5s Td]
Dealt to 3989b5f1 
Dealt to f3955548 
Dealt to 15c9222b 
15c9222b: checks
Hero: folds
3989b5f1: folds
f3955548: checks
*** FLOP *** [4s As 7d]
f3955548: bets $0.97 and is all-in
15c9222b: calls $0.48 and is all-in
Uncalled bet ($0.49) returned to f3955548
f3955548: shows [3s Ad] (Pair of Aces)
15c9222b: shows [Ac 9h] (Pair of Aces)
*** TURN *** [4s As 7d] [8s]
15c9222b: Chooses to EV Cashout 
*** RIVER *** [4s As 7d 8s] [2c]
15c9222b: Pays Cashout Risk ($0.27)
*** SHOWDOWN ***
15c9222b collected $0.94 from pot
*** SUMMARY ***
Total pot $1.01 | Rake $0.05 | Jackpot $0.02 | Bingo $0 | Fortune $0 | Tax $0
Board [4s As 7d 8s 2c]
Seat 1: Hero (button) folded before Flop (didn't bet)
Seat 4: 3989b5f1 (small blind) folded before Flop
Seat 5: f3955548 (big blind) showed [3s Ad] and lost with Pair of Aces
Seat 6: 15c9222b showed [Ac 9h] and won ($0.94) with Pair of Aces, Cashout Risk ($0.27)


Poker Hand #HD50899517: Hold'em No Limit ($0.01/$0.02) - 2024/05/21 19:32:54
Table 'NLHYellow5' 6-max Seat #5 is the button
Seat 1: Hero ($5.21 in chips)
Seat 3: 9c4b3ea8 ($2.31 in chips)
Seat 4: 3989b5f1 ($1.95 in chips)
Seat 5: f3955548 ($1.09 in chips)
Hero: posts small blind $0.01
9c4b3ea8: posts big blind $0.02
*** HOLE CARDS ***
Dealt to Hero [Ah 6h]
Dealt to 9c4b3ea8 
Dealt to 3989b5f1 
Dealt to f3955548 
3989b5f1: folds
f3955548: raises $0.08 to $0.1
Hero: calls $0.09
9c4b3ea8: folds
*** FLOP *** [6d 7h Th]
Hero: checks
f3955548: checks
*** TURN *** [6d 7h Th] [4s]
Hero: bets $0.11
f3955548: folds
Uncalled bet ($0.11) returned to Hero
*** SHOWDOWN ***
Hero collected $0.21 from pot
*** SUMMARY ***
Total pot $0.22 | Rake $0.01 | Jackpot $0 | Bingo $0 | Fortune $0 | Tax $0
Board [6d 7h Th 4s]
Seat 1: Hero (small blind) won ($0.21)
Seat 3: 9c4b3ea8 (big blind) folded before Flop
Seat 4: 3989b5f1 folded before Flop (didn't bet)
Seat 5: f3955548 (button) folded on the Turn


Poker Hand #HD50899505: Hold'em No Limit ($0.01/$0.02) - 2024/05/21 19:32:18
Table 'NLHYellow5' 6-max Seat #4 is the button
Seat 1: Hero ($5.23 in chips)
Seat 3: 9c4b3ea8 ($2.31 in chips)
Seat 4: 3989b5f1 ($2 in chips)
Seat 5: f3955548 ($1.02 in chips)
f3955548: posts small blind $0.01
Hero: posts big blind $0.02
*** HOLE CARDS ***
Dealt to Hero [Jh Qs]
Dealt to 9c4b3ea8 
Dealt to 3989b5f1 
Dealt to f3955548 
9c4b3ea8: folds
3989b5f1: raises $0.03 to $0.05
f3955548: raises $0.97 to $1.02 and is all-in
Hero: folds
3989b5f1: folds
Uncalled bet ($0.97) returned to f3955548
*** SHOWDOWN ***
f3955548 collected $0.12 from pot
*** SUMMARY ***
Total pot $0.12 | Rake $0 | Jackpot $0 | Bingo $0 | Fortune $0 | Tax $0
Seat 1: Hero (big blind) folded before Flop
Seat 3: 9c4b3ea8 folded before Flop (didn't bet)
Seat 4: 3989b5f1 (button) folded before Flop
Seat 5: f3955548 (small blind) collected ($0.12)


Poker Hand #HD50899479: Hold'em No Limit ($0.01/$0.02) - 2024/05/21 19:31:31
Table 'NLHYellow5' 6-max Seat #3 is the button
Seat 1: Hero ($5.16 in chips)
Seat 3: 9c4b3ea8 ($2.35 in chips)
Seat 4: 3989b5f1 ($2.01 in chips)
Seat 5: f3955548 ($1.04 in chips)
3989b5f1: posts small blind $0.01
f3955548: posts big blind $0.02
*** HOLE CARDS ***
Dealt to Hero [As 7s]
Dealt to 9c4b3ea8 
Dealt to 3989b5f1 
Dealt to f3955548 
Hero: raises $0.02 to $0.04
9c4b3ea8: calls $0.04
3989b5f1: folds
f3955548: folds
*** FLOP *** [7d 9h Js]
Hero: bets $0.04
9c4b3ea8: folds
Uncalled bet ($0.04) returned to Hero
*** SHOWDOWN ***
Hero collected $0.11 from pot
*** SUMMARY ***
Total pot $0.11 | Rake $0 | Jackpot $0 | Bingo $0 | Fortune $0 | Tax $0
Board [7d 9h Js]
Seat 1: Hero won ($0.11)
Seat 3: 9c4b3ea8 (button) folded on the Flop
Seat 4: 3989b5f1 (small blind) folded before Flop
Seat 5: f3955548 (big blind) folded before Flop


Poker Hand #HD50899469: Hold'em No Limit ($0.01/$0.02) - 2024/05/21 19:31:02
Table 'NLHYellow5' 6-max Seat #1 is the button
Seat 1: Hero ($5.16 in chips)
Seat 3: 9c4b3ea8 ($2.36 in chips)
Seat 4: 3989b5f1 ($2 in chips)
Seat 5: f3955548 ($1.04 in chips)
9c4b3ea8: posts small blind $0.01
3989b5f1: posts big blind $0.02
*** HOLE CARDS ***
Dealt to Hero [8c 3s]
Dealt to 9c4b3ea8 
Dealt to 3989b5f1 
Dealt to f3955548 
f3955548: folds
Hero: folds
9c4b3ea8: folds
Uncalled bet ($0.01) returned to 3989b5f1
*** SHOWDOWN ***
3989b5f1 collected $0.02 from pot
*** SUMMARY ***
Total pot $0.02 | Rake $0 | Jackpot $0 | Bingo $0 | Fortune $0 | Tax $0
Seat 1: Hero (button) folded before Flop (didn't bet)
Seat 3: 9c4b3ea8 (small blind) folded before Flop
Seat 4: 3989b5f1 (big blind) collected ($0.02)
Seat 5: f3955548 folded before Flop (didn't bet)


Poker Hand #HD50899441: Hold'em No Limit ($0.01/$0.02) - 2024/05/21 19:30:02
Table 'NLHYellow5' 6-max Seat #5 is the button
Seat 1: Hero ($5.18 in chips)
Seat 3: 9c4b3ea8 ($2.22 in chips)
Seat 5: f3955548 ($1.16 in chips)
Seat 6: fa231963 ($2.12 in chips)
fa231963: posts small blind $0.01
Hero: posts big blind $0.02
*** HOLE CARDS ***
Dealt to Hero [4c 7h]
Dealt to 9c4b3ea8 
Dealt to f3955548 
Dealt to fa231963 
9c4b3ea8: calls $0.02
f3955548: raises $0.04 to $0.06
fa231963: folds
Hero: folds
9c4b3ea8: calls $0.04
*** FLOP *** [4d 3h 7c]
9c4b3ea8: checks
f3955548: bets $0.06
9c4b3ea8: calls $0.06
*** TURN *** [4d 3h 7c] [Th]
9c4b3ea8: checks
f3955548: checks
*** RIVER *** [4d 3h 7c Th] [8h]
9c4b3ea8: bets $0.09
f3955548: folds
Uncalled bet ($0.09) returned to 9c4b3ea8
*** SHOWDOWN ***
9c4b3ea8 collected $0.26 from pot
*** SUMMARY ***
Total pot $0.27 | Rake $0.01 | Jackpot $0 | Bingo $0 | Fortune $0 | Tax $0
Board [4d 3h 7c Th 8h]
Seat 1: Hero (big blind) folded before Flop
Seat 3: 9c4b3ea8 won ($0.26)
Seat 5: f3955548 (button) folded on the River
Seat 6: fa231963 (small blind) folded before Flop


Poker Hand #HD50899433: Hold'em No Limit ($0.01/$0.02) - 2024/05/21 19:29:42
Table 'NLHYellow5' 6-max Seat #3 is the button
Seat 1: Hero ($5.18 in chips)
Seat 3: 9c4b3ea8 ($2.22 in chips)
Seat 5: f3955548 ($1.17 in chips)
Seat 6: fa231963 ($2.11 in chips)
f3955548: posts small blind $0.01
fa231963: posts big blind $0.02
*** HOLE CARDS ***
Dealt to Hero [Jd 2h]
Dealt to 9c4b3ea8 
Dealt to f3955548 
Dealt to fa231963 
Hero: folds
9c4b3ea8: folds
f3955548: folds
Uncalled bet ($0.01) returned to fa231963
*** SHOWDOWN ***
fa231963 collected $0.02 from pot
*** SUMMARY ***
Total pot $0.02 | Rake $0 | Jackpot $0 | Bingo $0 | Fortune $0 | Tax $0
Seat 1: Hero folded before Flop (didn't bet)
Seat 3: 9c4b3ea8 (button) folded before Flop (didn't bet)
Seat 5: f3955548 (small blind) folded before Flop
Seat 6: fa231963 (big blind) collected ($0.02)


Poker Hand #HD50899417: Hold'em No Limit ($0.01/$0.02) - 2024/05/21 19:29:03
Table 'NLHYellow5' 6-max Seat #1 is the button
Seat 1: Hero ($5.18 in chips)
Seat 2: 64a034ed ($0.21 in chips)
Seat 3: 9c4b3ea8 ($2.24 in chips)
Seat 4: 831819ea ($1.55 in chips)
Seat 5: f3955548 ($1.17 in chips)
Seat 6: fa231963 ($2.07 in chips)
64a034ed: posts small blind $0.01
9c4b3ea8: posts big blind $0.02
*** HOLE CARDS ***
Dealt to Hero [Kd 6s]
Dealt to 64a034ed 
Dealt to 9c4b3ea8 
Dealt to 831819ea 
Dealt to f3955548 
Dealt to fa231963 
831819ea: folds
f3955548: folds
fa231963: raises $0.04 to $0.06
Hero: folds
64a034ed: raises $0.15 to $0.21 and is all-in
9c4b3ea8: folds
fa231963: calls $0.15
64a034ed: shows [Tc Kc]
fa231963: shows [5c 3d]
*** FLOP *** [5s Jd As]
fa231963: Chooses to EV Cashout 
*** TURN *** [5s Jd As] [2d]
*** RIVER *** [5s Jd As 2d] [Js]
fa231963: Pays Cashout Risk ($0.17)
*** SHOWDOWN ***
fa231963 collected $0.42 from pot
*** SUMMARY ***
Total pot $0.44 | Rake $0.02 | Jackpot $0 | Bingo $0 | Fortune $0 | Tax $0
Board [5s Jd As 2d Js]
Seat 1: Hero (button) folded before Flop (didn't bet)
Seat 2: 64a034ed (small blind) showed [Tc Kc] and lost with Pair of Jacks
Seat 3: 9c4b3ea8 (big blind) folded before Flop
Seat 4: 831819ea folded before Flop (didn't bet)
Seat 5: f3955548 folded before Flop (didn't bet)
Seat 6: fa231963 showed [5c 3d] and won ($0.42) with Pair of Jacks and Pair of Fives, Cashout Risk ($0.17)


Poker Hand #HD50899387: Hold'em No Limit ($0.01/$0.02) - 2024/05/21 19:27:53
Table 'NLHYellow5' 6-max Seat #6 is the button
Seat 1: Hero ($5.19 in chips)
Seat 2: 64a034ed ($1 in chips)
Seat 3: 9c4b3ea8 ($2.24 in chips)
Seat 4: 831819ea ($0.84 in chips)
Seat 5: f3955548 ($1.17 in chips)
Seat 6: fa231963 ($2.07 in chips)
Hero: posts small blind $0.01
64a034ed: posts big blind $0.02
*** HOLE CARDS ***
Dealt to Hero [Js 4c]
Dealt to 64a034ed 
Dealt to 9c4b3ea8 
Dealt to 831819ea 
Dealt to f3955548 
Dealt to fa231963 
9c4b3ea8: folds
831819ea: raises $0.04 to $0.06
f3955548: folds
fa231963: folds
Hero: folds
64a034ed: calls $0.04
*** FLOP *** [6s 3s 3c]
64a034ed: checks
831819ea: bets $0.1
64a034ed: calls $0.1
*** TURN *** [6s 3s 3c] [8c]
64a034ed: bets $0.17
831819ea: calls $0.17
*** RIVER *** [6s 3s 3c 8c] [5h]
64a034ed: bets $0.14
831819ea: raises $0.32 to $0.46
64a034ed: calls $0.32
831819ea: shows [Tc Td] (Pair of Tens and Pair of Treys)
64a034ed: shows [6d Ac] (Pair of Sixes and Pair of Treys)
*** SHOWDOWN ***
831819ea collected $1.5 from pot
*** SUMMARY ***
Total pot $1.59 | Rake $0.07 | Jackpot $0.02 | Bingo $0 | Fortune $0 | Tax $0
Board [6s 3s 3c 8c 5h]
Seat 1: Hero (small blind) folded before Flop
Seat 2: 64a034ed (big blind) showed [6d Ac] and lost with Pair of Sixes and Pair of Treys
Seat 3: 9c4b3ea8 folded before Flop (didn't bet)
Seat 4: 831819ea showed [Tc Td] and won ($1.5) with Pair of Tens and Pair of Treys
Seat 5: f3955548 folded before Flop (didn't bet)
Seat 6: fa231963 (button) folded before Flop (didn't bet)


Poker Hand #HD50899378: Hold'em No Limit ($0.01/$0.02) - 2024/05/21 19:27:27
Table 'NLHYellow5' 6-max Seat #5 is the button
Seat 1: Hero ($5.21 in chips)
Seat 3: 9c4b3ea8 ($2.24 in chips)
Seat 4: 831819ea ($0.92 in chips)
Seat 5: f3955548 ($1.17 in chips)
Seat 6: fa231963 ($1.97 in chips)
fa231963: posts small blind $0.01
Hero: posts big blind $0.02
*** HOLE CARDS ***
Dealt to Hero [Kh 8s]
Dealt to 9c4b3ea8 
Dealt to 831819ea 
Dealt to f3955548 
Dealt to fa231963 
9c4b3ea8: folds
831819ea: calls $0.02
f3955548: folds
fa231963: raises $0.06 to $0.08
Hero: folds
831819ea: calls $0.06
*** FLOP *** [9d 2s 4h]
fa231963: bets $0.14
831819ea: folds
Uncalled bet ($0.14) returned to fa231963
*** SHOWDOWN ***
fa231963 collected $0.18 from pot
*** SUMMARY ***
Total pot $0.18 | Rake $0 | Jackpot $0 | Bingo $0 | Fortune $0 | Tax $0
Board [9d 2s 4h]
Seat 1: Hero (big blind) folded before Flop
Seat 3: 9c4b3ea8 folded before Flop (didn't bet)
Seat 4: 831819ea folded on the Flop
Seat 5: f3955548 (button) folded before Flop (didn't bet)
Seat 6: fa231963 (small blind) won ($0.18)


Poker Hand #HD50899351: Hold'em No Limit ($0.01/$0.02) - 2024/05/21 19:26:06
Table 'NLHYellow5' 6-max Seat #4 is the button
Seat 1: Hero ($5.21 in chips)
Seat 3: 9c4b3ea8 ($2 in chips)
Seat 4: 831819ea ($1.09 in chips)
Seat 5: f3955548 ($1.18 in chips)
Seat 6: fa231963 ($2.05 in chips)
f3955548: posts small blind $0.01
fa231963: posts big blind $0.02
*** HOLE CARDS ***
Dealt to Hero [6s 4d]
Dealt to 9c4b3ea8 
Dealt to 831819ea 
Dealt to f3955548 
Dealt to fa231963 
Hero: folds
9c4b3ea8: calls $0.02
831819ea: calls $0.02
f3955548: folds
fa231963: checks
*** FLOP *** [7c Ts 6c]
fa231963: checks
9c4b3ea8: bets $0.06
831819ea: calls $0.06
fa231963: calls $0.06
*** TURN *** [7c Ts 6c] [Ks]
fa231963: checks
9c4b3ea8: checks
831819ea: checks
*** RIVER *** [7c Ts 6c Ks] [8s]
fa231963: checks
9c4b3ea8: bets $0.09
831819ea: calls $0.09
fa231963: folds
9c4b3ea8: shows [Tc 9d] (Tens-High Straight)
831819ea: shows [Td Jh] (Pair of Tens)
*** SHOWDOWN ***
9c4b3ea8 collected $0.41 from pot
*** SUMMARY ***
Total pot $0.43 | Rake $0.02 | Jackpot $0 | Bingo $0 | Fortune $0 | Tax $0
Board [7c Ts 6c Ks 8s]
Seat 1: Hero folded before Flop (didn't bet)
Seat 3: 9c4b3ea8 showed [Tc 9d] and won ($0.41) with Tens-High Straight
Seat 4: 831819ea (button) showed [Td Jh] and lost with Pair of Tens
Seat 5: f3955548 (small blind) folded before Flop
Seat 6: fa231963 (big blind) folded on the River


Poker Hand #HD50899341: Hold'em No Limit ($0.01/$0.02) - 2024/05/21 19:25:29
Table 'NLHYellow5' 6-max Seat #3 is the button
Seat 1: Hero ($5.21 in chips)
Seat 3: 9c4b3ea8 ($2 in chips)
Seat 4: 831819ea ($1.11 in chips)
Seat 5: f3955548 ($1.14 in chips)
Seat 6: fa231963 ($2.05 in chips)
831819ea: posts small blind $0.01
f3955548: posts big blind $0.02
*** HOLE CARDS ***
Dealt to Hero [6d 2c]
Dealt to 9c4b3ea8 
Dealt to 831819ea 
Dealt to f3955548 
Dealt to fa231963 
fa231963: folds
Hero: folds
9c4b3ea8: calls $0.02
831819ea: calls $0.01
f3955548: raises $1.12 to $1.14 and is all-in
9c4b3ea8: folds
831819ea: folds
Uncalled bet ($1.12) returned to f3955548
*** SHOWDOWN ***
f3955548 collected $0.06 from pot
*** SUMMARY ***
Total pot $0.06 | Rake $0 | Jackpot $0 | Bingo $0 | Fortune $0 | Tax $0
Seat 1: Hero folded before Flop (didn't bet)
Seat 3: 9c4b3ea8 (button) folded before Flop
Seat 4: 831819ea (small blind) folded before Flop
Seat 5: f3955548 (big blind) collected ($0.06)
Seat 6: fa231963 folded before Flop (didn't bet)


Poker Hand #HD50899322: Hold'em No Limit ($0.01/$0.02) - 2024/05/21 19:24:26
Table 'NLHYellow5' 6-max Seat #1 is the button
Seat 1: Hero ($4.35 in chips)
Seat 3: 9c4b3ea8 ($2 in chips)
Seat 4: 831819ea ($2 in chips)
Seat 5: f3955548 ($1.15 in chips)
Seat 6: fa231963 ($2.11 in chips)
9c4b3ea8: posts small blind $0.01
831819ea: posts big blind $0.02
f3955548: posts missed blind $0.01
*** HOLE CARDS ***
Dealt to Hero [Jd Js]
Dealt to 9c4b3ea8 
Dealt to 831819ea 
Dealt to f3955548 
Dealt to fa231963 
f3955548: folds
fa231963: raises $0.04 to $0.06
Hero: raises $0.12 to $0.18
9c4b3ea8: folds
831819ea: calls $0.16
fa231963: folds
*** FLOP *** [4d Qd Kd]
831819ea: checks
Hero: bets $0.15
831819ea: calls $0.15
*** TURN *** [4d Qd Kd] [2d]
831819ea: checks
Hero: checks
*** RIVER *** [4d Qd Kd 2d] [Qc]
831819ea: checks
Hero: bets $0.56
831819ea: calls $0.56
Hero: shows [Jd Js] (King High Flush)
831819ea: shows [Kc 3c] (Pair of Kings and Pair of Queens)
*** SHOWDOWN ***
Hero collected $1.75 from pot
*** SUMMARY ***
Total pot $1.86 | Rake $0.09 | Jackpot $0.02 | Bingo $0 | Fortune $0 | Tax $0
Board [4d Qd Kd 2d Qc]
Seat 1: Hero (button) showed [Jd Js] and won ($1.75) with King High Flush
Seat 3: 9c4b3ea8 (small blind) folded before Flop
Seat 4: 831819ea (big blind) showed [Kc 3c] and lost with Pair of Kings and Pair of Queens
Seat 5: f3955548 folded before Flop
Seat 6: fa231963 folded before Flop


Poker Hand #HD50899312: Hold'em No Limit ($0.01/$0.02) - 2024/05/21 19:23:56
Table 'NLHYellow5' 6-max Seat #6 is the button
Seat 1: Hero ($4.36 in chips)
Seat 3: 9c4b3ea8 ($2 in chips)
Seat 6: fa231963 ($2.08 in chips)
Hero: posts small blind $0.01
9c4b3ea8: posts big blind $0.02
*** HOLE CARDS ***
Dealt to Hero [6s 8c]
Dealt to 9c4b3ea8 
Dealt to fa231963 
fa231963: calls $0.02
Hero: folds
9c4b3ea8: checks
*** FLOP *** [Ad 7h 7s]
9c4b3ea8: checks
fa231963: bets $0.04
9c4b3ea8: folds
Uncalled bet ($0.04) returned to fa231963
*** SHOWDOWN ***
fa231963 collected $0.05 from pot
*** SUMMARY ***
Total pot $0.05 | Rake $0 | Jackpot $0 | Bingo $0 | Fortune $0 | Tax $0
Board [Ad 7h 7s]
Seat 1: Hero (small blind) folded before Flop
Seat 3: 9c4b3ea8 (big blind) folded on the Flop
Seat 6: fa231963 (button) won ($0.05)


Poker Hand #HD50899268: Hold'em No Limit ($0.01/$0.02) - 2024/05/21 19:21:49
Table 'NLHYellow5' 6-max Seat #3 is the button
Seat 1: Hero ($2.53 in chips)
Seat 2: 5a5d73f ($2.87 in chips)
Seat 3: 9c4b3ea8 ($2.01 in chips)
Seat 6: fa231963 ($2.09 in chips)
fa231963: posts small blind $0.01
Hero: posts big blind $0.02
5a5d73f: posts missed blind $0.01
5a5d73f: posts big blind $0.02
*** HOLE CARDS ***
Dealt to Hero [Ad Qh]
Dealt to 5a5d73f 
Dealt to 9c4b3ea8 
Dealt to fa231963 
5a5d73f: checks
9c4b3ea8: raises $0.08 to $0.1
fa231963: folds
Hero: raises $0.24 to $0.34
5a5d73f: folds
9c4b3ea8: calls $0.24
*** FLOP *** [Ah Jh 2h]
Hero: bets $0.24
9c4b3ea8: calls $0.24
*** TURN *** [Ah Jh 2h] [Js]
Hero: bets $0.4
9c4b3ea8: calls $0.4
*** RIVER *** [Ah Jh 2h Js] [Ts]
Hero: bets $1.55 and is all-in
9c4b3ea8: calls $1.03 and is all-in
Uncalled bet ($0.52) returned to Hero
Hero: shows [Ad Qh] (Pair of Aces and Pair of Jacks)
9c4b3ea8: shows [Qd Qs] (Pair of Queens and Pair of Jacks)
*** SHOWDOWN ***
Hero collected $3.84 from pot
*** SUMMARY ***
Total pot $4.06 | Rake $0.2 | Jackpot $0.02 | Bingo $0 | Fortune $0 | Tax $0
Board [Ah Jh 2h Js Ts]
Seat 1: Hero (big blind) showed [Ad Qh] and won ($3.84) with Pair of Aces and Pair of Jacks
Seat 2: 5a5d73f folded before Flop
Seat 3: 9c4b3ea8 (button) showed [Qd Qs] and lost with Pair of Queens and Pair of Jacks
Seat 6: fa231963 (small blind) folded before Flop


Poker Hand #HD50899252: Hold'em No Limit ($0.01/$0.02) - 2024/05/21 19:21:01
Table 'NLHYellow5' 6-max Seat #1 is the button
Seat 1: Hero ($2.53 in chips)
Seat 3: 9c4b3ea8 ($2.02 in chips)
Seat 5: f3955548 ($1.19 in chips)
Seat 6: fa231963 ($2.04 in chips)
9c4b3ea8: posts small blind $0.01
f3955548: posts big blind $0.02
*** HOLE CARDS ***
Dealt to Hero [6s 5c]
Dealt to 9c4b3ea8 
Dealt to f3955548 
Dealt to fa231963 
fa231963: calls $0.02
Hero: folds
9c4b3ea8: folds
f3955548: checks
*** FLOP *** [6c Ah 5h]
f3955548: checks
fa231963: checks
*** TURN *** [6c Ah 5h] [Th]
f3955548: checks
fa231963: checks
*** RIVER *** [6c Ah 5h Th] [4d]
f3955548: bets $0.02
fa231963: raises $0.08 to $0.1
f3955548: folds
Uncalled bet ($0.08) returned to fa231963
*** SHOWDOWN ***
fa231963 collected $0.09 from pot
*** SUMMARY ***
Total pot $0.09 | Rake $0 | Jackpot $0 | Bingo $0 | Fortune $0 | Tax $0
Board [6c Ah 5h Th 4d]
Seat 1: Hero (button) folded before Flop (didn't bet)
Seat 3: 9c4b3ea8 (small blind) folded before Flop
Seat 5: f3955548 (big blind) folded on the River
Seat 6: fa231963 won ($0.09)


Poker Hand #HD50899242: Hold'em No Limit ($0.01/$0.02) - 2024/05/21 19:20:29
Table 'NLHYellow5' 6-max Seat #6 is the button
Seat 1: Hero ($2.57 in chips)
Seat 3: 9c4b3ea8 ($2.04 in chips)
Seat 4: 471ef91f ($0.89 in chips)
Seat 5: f3955548 ($1.23 in chips)
Seat 6: fa231963 ($1.94 in chips)
Hero: posts small blind $0.01
9c4b3ea8: posts big blind $0.02
*** HOLE CARDS ***
Dealt to Hero [7d As]
Dealt to 9c4b3ea8 
Dealt to 471ef91f 
Dealt to f3955548 
Dealt to fa231963 
471ef91f: folds
f3955548: raises $0.02 to $0.04
fa231963: calls $0.04
Hero: calls $0.03
9c4b3ea8: folds
*** FLOP *** [8h Ts Th]
Hero: checks
f3955548: checks
fa231963: bets $0.11
Hero: folds
f3955548: folds
Uncalled bet ($0.11) returned to fa231963
*** SHOWDOWN ***
fa231963 collected $0.14 from pot
*** SUMMARY ***
Total pot $0.14 | Rake $0 | Jackpot $0 | Bingo $0 | Fortune $0 | Tax $0
Board [8h Ts Th]
Seat 1: Hero (small blind) folded on the Flop
Seat 3: 9c4b3ea8 (big blind) folded before Flop
Seat 4: 471ef91f folded before Flop (didn't bet)
Seat 5: f3955548 folded on the Flop
Seat 6: fa231963 (button) won ($0.14)


Poker Hand #HD50899224: Hold'em No Limit ($0.01/$0.02) - 2024/05/21 19:19:30
Table 'NLHYellow5' 6-max Seat #5 is the button
Seat 1: Hero ($2.59 in chips)
Seat 2: 5a5d73f ($2.87 in chips)
Seat 4: 471ef91f ($1.53 in chips)
Seat 5: f3955548 ($0.64 in chips)
Seat 6: fa231963 ($1.95 in chips)
fa231963: posts small blind $0.01
Hero: posts big blind $0.02
*** HOLE CARDS ***
Dealt to Hero [Qh Jd]
Dealt to 5a5d73f 
Dealt to 471ef91f 
Dealt to f3955548 
Dealt to fa231963 
5a5d73f: folds
471ef91f: raises $0.04 to $0.06
f3955548: raises $0.58 to $0.64 and is all-in
fa231963: folds
Hero: folds
471ef91f: calls $0.58
f3955548: shows [Tc Kc]
471ef91f: shows [7d 7h]
*** FLOP *** [4c Th Ts]
*** TURN *** [4c Th Ts] [4h]
*** RIVER *** [4c Th Ts 4h] [8c]
fa231963: shows [Td] (Tens Full over Fours)
*** SHOWDOWN ***
f3955548 collected $1.23 from pot
*** SUMMARY ***
Total pot $1.31 | Rake $0.06 | Jackpot $0.02 | Bingo $0 | Fortune $0 | Tax $0
Board [4c Th Ts 4h 8c]
Seat 1: Hero (big blind) folded before Flop
Seat 2: 5a5d73f folded before Flop (didn't bet)
Seat 4: 471ef91f showed [7d 7h] and lost with Pair of Tens and Pair of Sevens
Seat 5: f3955548 (button) showed [Tc Kc] and won ($1.23) with Tens Full over Fours
Seat 6: fa231963 (small blind) folded before Flop


Poker Hand #HD50899213: Hold'em No Limit ($0.01/$0.02) - 2024/05/21 19:18:58
Table 'NLHYellow5' 6-max Seat #4 is the button
Seat 1: Hero ($2.64 in chips)
Seat 2: 5a5d73f ($2.87 in chips)
Seat 4: 471ef91f ($1.53 in chips)
Seat 5: f3955548 ($0.54 in chips)
Seat 6: fa231963 ($2 in chips)
f3955548: posts small blind $0.01
fa231963: posts big blind $0.02
*** HOLE CARDS ***
Dealt to Hero [Jc Js]
Dealt to 5a5d73f 
Dealt to 471ef91f 
Dealt to f3955548 
Dealt to fa231963 
Hero: raises $0.03 to $0.05
5a5d73f: folds
471ef91f: folds
f3955548: calls $0.04
fa231963: calls $0.03
*** FLOP *** [Ks Kd Ac]
f3955548: bets $0.49 and is all-in
fa231963: folds
Hero: folds
Uncalled bet ($0.49) returned to f3955548
*** SHOWDOWN ***
f3955548 collected $0.15 from pot
*** SUMMARY ***
Total pot $0.15 | Rake $0 | Jackpot $0 | Bingo $0 | Fortune $0 | Tax $0
Board [Ks Kd Ac]
Seat 1: Hero folded on the Flop
Seat 2: 5a5d73f folded before Flop (didn't bet)
Seat 4: 471ef91f (button) folded before Flop (didn't bet)
Seat 5: f3955548 (small blind) won ($0.15)
Seat 6: fa231963 (big blind) folded on the Flop


Poker Hand #HD50899206: Hold'em No Limit ($0.01/$0.02) - 2024/05/21 19:18:49
Table 'NLHYellow5' 6-max Seat #2 is the button
Seat 1: Hero ($2.64 in chips)
Seat 2: 5a5d73f ($2.87 in chips)
Seat 4: 471ef91f ($1.54 in chips)
Seat 5: f3955548 ($0.53 in chips)
471ef91f: posts small blind $0.01
f3955548: posts big blind $0.02
*** HOLE CARDS ***
Dealt to Hero [3s 9c]
Dealt to 5a5d73f 
Dealt to 471ef91f 
Dealt to f3955548 
Hero: folds
5a5d73f: folds
471ef91f: folds
Uncalled bet ($0.01) returned to f3955548
*** SHOWDOWN ***
f3955548 collected $0.02 from pot
*** SUMMARY ***
Total pot $0.02 | Rake $0 | Jackpot $0 | Bingo $0 | Fortune $0 | Tax $0
Seat 1: Hero folded before Flop (didn't bet)
Seat 2: 5a5d73f (button) folded before Flop (didn't bet)
Seat 4: 471ef91f (small blind) folded before Flop
Seat 5: f3955548 (big blind) collected ($0.02)


Poker Hand #HD50899201: Hold'em No Limit ($0.01/$0.02) - 2024/05/21 19:18:39
Table 'NLHYellow5' 6-max Seat #1 is the button
Seat 1: Hero ($2.64 in chips)
Seat 2: 5a5d73f ($2.88 in chips)
Seat 4: 471ef91f ($1.56 in chips)
Seat 5: f3955548 ($0.5 in chips)
5a5d73f: posts small blind $0.01
471ef91f: posts big blind $0.02
f3955548: posts big blind $0.02
*** HOLE CARDS ***
Dealt to Hero [4h Tc]
Dealt to 5a5d73f 
Dealt to 471ef91f 
Dealt to f3955548 
f3955548: raises $0.04 to $0.06
Hero: folds
5a5d73f: folds
471ef91f: folds
Uncalled bet ($0.04) returned to f3955548
*** SHOWDOWN ***
f3955548 collected $0.05 from pot
*** SUMMARY ***
Total pot $0.05 | Rake $0 | Jackpot $0 | Bingo $0 | Fortune $0 | Tax $0
Seat 1: Hero (button) folded before Flop (didn't bet)
Seat 2: 5a5d73f (small blind) folded before Flop
Seat 4: 471ef91f (big blind) folded before Flop
Seat 5: f3955548 collected ($0.05)


Poker Hand #HD50899190: Hold'em No Limit ($0.01/$0.02) - 2024/05/21 19:18:09
Table 'NLHYellow5' 6-max Seat #4 is the button
Seat 1: Hero ($2.62 in chips)
Seat 2: 5a5d73f ($2.9 in chips)
Seat 4: 471ef91f ($1.56 in chips)
Hero: posts small blind $0.01
5a5d73f: posts big blind $0.02
*** HOLE CARDS ***
Dealt to Hero [Td 7d]
Dealt to 5a5d73f 
Dealt to 471ef91f 
471ef91f: folds
Hero: calls $0.01
5a5d73f: checks
*** FLOP *** [Ah 2h Qc]
Hero: checks
5a5d73f: checks
*** TURN *** [Ah 2h Qc] [5d]
Hero: bets $0.02
5a5d73f: folds
Uncalled bet ($0.02) returned to Hero
*** SHOWDOWN ***
Hero collected $0.04 from pot
*** SUMMARY ***
Total pot $0.04 | Rake $0 | Jackpot $0 | Bingo $0 | Fortune $0 | Tax $0
Board [Ah 2h Qc 5d]
Seat 1: Hero (small blind) won ($0.04)
Seat 2: 5a5d73f (big blind) folded on the Turn
Seat 4: 471ef91f (button) folded before Flop (didn't bet)


Poker Hand #HD50899171: Hold'em No Limit ($0.01/$0.02) - 2024/05/21 19:17:20
Table 'NLHYellow5' 6-max Seat #3 is the button
Seat 1: Hero ($2.58 in chips)
Seat 2: 5a5d73f ($2.92 in chips)
Seat 3: 9c4b3ea8 ($2.04 in chips)
Seat 4: 471ef91f ($1.58 in chips)
471ef91f: posts small blind $0.01
Hero: posts big blind $0.02
*** HOLE CARDS ***
Dealt to Hero [5s 8c]
Dealt to 5a5d73f 
Dealt to 9c4b3ea8 
Dealt to 471ef91f 
5a5d73f: calls $0.02
9c4b3ea8: folds
471ef91f: calls $0.01
Hero: checks
*** FLOP *** [Ts 9c 7h]
471ef91f: checks
Hero: checks
5a5d73f: checks
*** TURN *** [Ts 9c 7h] [Jd]
471ef91f: checks
Hero: bets $0.05
5a5d73f: folds
471ef91f: folds
Uncalled bet ($0.05) returned to Hero
*** SHOWDOWN ***
Hero collected $0.06 from pot
*** SUMMARY ***
Total pot $0.06 | Rake $0 | Jackpot $0 | Bingo $0 | Fortune $0 | Tax $0
Board [Ts 9c 7h Jd]
Seat 1: Hero (big blind) won ($0.06)
Seat 2: 5a5d73f folded on the Turn
Seat 3: 9c4b3ea8 (button) folded before Flop (didn't bet)
Seat 4: 471ef91f (small blind) folded on the Turn


Poker Hand #HD50899141: Hold'em No Limit ($0.01/$0.02) - 2024/05/21 19:15:58
Table 'NLHYellow5' 6-max Seat #2 is the button
Seat 1: Hero ($2.58 in chips)
Seat 2: 5a5d73f ($2.94 in chips)
Seat 3: 9c4b3ea8 ($2 in chips)
Seat 4: 471ef91f ($1.6 in chips)
Seat 6: 52daa2a3 ($2.37 in chips)
9c4b3ea8: posts small blind $0.01
471ef91f: posts big blind $0.02
*** HOLE CARDS ***
Dealt to Hero [9c Th]
Dealt to 5a5d73f 
Dealt to 9c4b3ea8 
Dealt to 471ef91f 
Dealt to 52daa2a3 
52daa2a3: folds
Hero: folds
5a5d73f: calls $0.02
9c4b3ea8: calls $0.01
471ef91f: checks
*** FLOP *** [Jh 6s Js]
9c4b3ea8: checks
471ef91f: checks
5a5d73f: checks
*** TURN *** [Jh 6s Js] [Ks]
9c4b3ea8: checks
471ef91f: checks
5a5d73f: checks
*** RIVER *** [Jh 6s Js Ks] [3c]
9c4b3ea8: checks
471ef91f: checks
5a5d73f: checks
9c4b3ea8: shows [3h 7h] (Pair of Jacks and Pair of Treys)
471ef91f: shows [9h 8c] (Pair of Jacks)
5a5d73f: shows [Ts Qd] (Pair of Jacks)
*** SHOWDOWN ***
9c4b3ea8 collected $0.06 from pot
*** SUMMARY ***
Total pot $0.06 | Rake $0 | Jackpot $0 | Bingo $0 | Fortune $0 | Tax $0
Board [Jh 6s Js Ks 3c]
Seat 1: Hero folded before Flop (didn't bet)
Seat 2: 5a5d73f (button) showed [Ts Qd] and lost with Pair of Jacks
Seat 3: 9c4b3ea8 (small blind) showed [3h 7h] and won ($0.06) with Pair of Jacks and Pair of Treys
Seat 4: 471ef91f (big blind) showed [9h 8c] and lost with Pair of Jacks
Seat 6: 52daa2a3 folded before Flop (didn't bet)


Poker Hand #HD50899126: Hold'em No Limit ($0.01/$0.02) - 2024/05/21 19:15:05
Table 'NLHYellow5' 6-max Seat #1 is the button
Seat 1: Hero ($2.58 in chips)
Seat 2: 5a5d73f ($2.95 in chips)
Seat 3: 9c4b3ea8 ($2 in chips)
Seat 4: 471ef91f ($1.6 in chips)
Seat 6: 52daa2a3 ($2.12 in chips)
5a5d73f: posts small blind $0.01
9c4b3ea8: posts big blind $0.02
*** HOLE CARDS ***
Dealt to Hero [Qc 6h]
Dealt to 5a5d73f 
Dealt to 9c4b3ea8 
Dealt to 471ef91f 
Dealt to 52daa2a3 
471ef91f: folds
52daa2a3: raises $0.04 to $0.06
Hero: folds
5a5d73f: folds
9c4b3ea8: raises $0.04 to $0.1
52daa2a3: calls $0.04
*** FLOP *** [Th 8h 5d]
9c4b3ea8: checks
52daa2a3: bets $0.16
9c4b3ea8: calls $0.16
*** TURN *** [Th 8h 5d] [6s]
9c4b3ea8: checks
52daa2a3: bets $0.4
9c4b3ea8: folds
Uncalled bet ($0.4) returned to 52daa2a3
*** SHOWDOWN ***
52daa2a3 collected $0.51 from pot
*** SUMMARY ***
Total pot $0.53 | Rake $0.02 | Jackpot $0 | Bingo $0 | Fortune $0 | Tax $0
Board [Th 8h 5d 6s]
Seat 1: Hero (button) folded before Flop (didn't bet)
Seat 2: 5a5d73f (small blind) folded before Flop
Seat 3: 9c4b3ea8 (big blind) folded on the Turn
Seat 4: 471ef91f folded before Flop (didn't bet)
Seat 6: 52daa2a3 won ($0.51)


Poker Hand #HD50899115: Hold'em No Limit ($0.01/$0.02) - 2024/05/21 19:14:35
Table 'NLHYellow5' 6-max Seat #6 is the button
Seat 1: Hero ($2.59 in chips)
Seat 2: 5a5d73f ($2.97 in chips)
Seat 3: 9c4b3ea8 ($2 in chips)
Seat 4: 471ef91f ($1.68 in chips)
Seat 6: 52daa2a3 ($2.02 in chips)
Hero: posts small blind $0.01
5a5d73f: posts big blind $0.02
*** HOLE CARDS ***
Dealt to Hero [3h 5s]
Dealt to 5a5d73f 
Dealt to 9c4b3ea8 
Dealt to 471ef91f 
Dealt to 52daa2a3 
9c4b3ea8: folds
471ef91f: calls $0.02
52daa2a3: raises $0.06 to $0.08
Hero: folds
5a5d73f: folds
471ef91f: calls $0.06
*** FLOP *** [3s 6d 7h]
471ef91f: checks
52daa2a3: bets $0.15
471ef91f: folds
Uncalled bet ($0.15) returned to 52daa2a3
*** SHOWDOWN ***
52daa2a3 collected $0.18 from pot
*** SUMMARY ***
Total pot $0.19 | Rake $0.01 | Jackpot $0 | Bingo $0 | Fortune $0 | Tax $0
Board [3s 6d 7h]
Seat 1: Hero (small blind) folded before Flop
Seat 2: 5a5d73f (big blind) folded before Flop
Seat 3: 9c4b3ea8 folded before Flop (didn't bet)
Seat 4: 471ef91f folded on the Flop
Seat 6: 52daa2a3 (button) won ($0.18)


Poker Hand #HD50899083: Hold'em No Limit ($0.01/$0.02) - 2024/05/21 19:13:12
Table 'NLHYellow5' 6-max Seat #4 is the button
Seat 1: Hero ($2.28 in chips)
Seat 2: 5a5d73f ($3.04 in chips)
Seat 3: 9c4b3ea8 ($2 in chips)
Seat 4: 471ef91f ($1.7 in chips)
Seat 6: 52daa2a3 ($2.03 in chips)
52daa2a3: posts small blind $0.01
Hero: posts big blind $0.02
*** HOLE CARDS ***
Dealt to Hero [Js Th]
Dealt to 5a5d73f 
Dealt to 9c4b3ea8 
Dealt to 471ef91f 
Dealt to 52daa2a3 
5a5d73f: calls $0.02
9c4b3ea8: calls $0.02
471ef91f: calls $0.02
52daa2a3: folds
Hero: checks
*** FLOP *** [6d 9h 8c]
Hero: bets $0.05
5a5d73f: calls $0.05
9c4b3ea8: calls $0.05
471ef91f: folds
*** TURN *** [6d 9h 8c] [Ad]
Hero: checks
5a5d73f: checks
9c4b3ea8: bets $0.18
Hero: calls $0.18
5a5d73f: folds
*** RIVER *** [6d 9h 8c Ad] [8h]
Hero: checks
9c4b3ea8: checks
Hero: shows [Js Th] (Pair of Eights)
9c4b3ea8: shows [7d Jd] (Pair of Eights)
*** SHOWDOWN ***
Hero collected $0.56 from pot
*** SUMMARY ***
Total pot $0.6 | Rake $0.02 | Jackpot $0.02 | Bingo $0 | Fortune $0 | Tax $0
Board [6d 9h 8c Ad 8h]
Seat 1: Hero (big blind) showed [Js Th] and won ($0.56) with Pair of Eights
Seat 2: 5a5d73f folded on the Turn
Seat 3: 9c4b3ea8 showed [7d Jd] and lost with Pair of Eights
Seat 4: 471ef91f (button) folded on the Flop
Seat 6: 52daa2a3 (small blind) folded before Flop


Poker Hand #HD50899069: Hold'em No Limit ($0.01/$0.02) - 2024/05/21 19:12:48
Table 'NLHYellow5' 6-max Seat #3 is the button
Seat 1: Hero ($2.28 in chips)
Seat 3: 9c4b3ea8 ($2 in chips)
Seat 4: 471ef91f ($1.68 in chips)
Seat 6: 52daa2a3 ($2.05 in chips)
471ef91f: posts small blind $0.01
52daa2a3: posts big blind $0.02
*** HOLE CARDS ***
Dealt to Hero [Jd 7c]
Dealt to 9c4b3ea8 
Dealt to 471ef91f 
Dealt to 52daa2a3 
Hero: folds
9c4b3ea8: folds
471ef91f: raises $0.02 to $0.04
52daa2a3: folds
Uncalled bet ($0.02) returned to 471ef91f
*** SHOWDOWN ***
471ef91f collected $0.04 from pot
*** SUMMARY ***
Total pot $0.04 | Rake $0 | Jackpot $0 | Bingo $0 | Fortune $0 | Tax $0
Seat 1: Hero folded before Flop (didn't bet)
Seat 3: 9c4b3ea8 (button) folded before Flop (didn't bet)
Seat 4: 471ef91f (small blind) collected ($0.04)
Seat 6: 52daa2a3 (big blind) folded before Flop


Poker Hand #HD50899060: Hold'em No Limit ($0.01/$0.02) - 2024/05/21 19:12:24
Table 'NLHYellow5' 6-max Seat #1 is the button
Seat 1: Hero ($2.25 in chips)
Seat 2: 5a5d73f ($3.05 in chips)
Seat 3: 9c4b3ea8 ($2 in chips)
Seat 4: 471ef91f ($1.68 in chips)
Seat 5: 2902f8c8 ($3.45 in chips)
Seat 6: 52daa2a3 ($2.05 in chips)
5a5d73f: posts small blind $0.01
9c4b3ea8: posts big blind $0.02
*** HOLE CARDS ***
Dealt to Hero [9d Qd]
Dealt to 5a5d73f 
Dealt to 9c4b3ea8 
Dealt to 471ef91f 
Dealt to 2902f8c8 
Dealt to 52daa2a3 
471ef91f: folds
2902f8c8: folds
52daa2a3: folds
Hero: raises $0.03 to $0.05
5a5d73f: folds
9c4b3ea8: folds
Uncalled bet ($0.03) returned to Hero
*** SHOWDOWN ***
Hero collected $0.05 from pot
*** SUMMARY ***
Total pot $0.05 | Rake $0 | Jackpot $0 | Bingo $0 | Fortune $0 | Tax $0
Seat 1: Hero (button) collected ($0.05)
Seat 2: 5a5d73f (small blind) folded before Flop
Seat 3: 9c4b3ea8 (big blind) folded before Flop
Seat 4: 471ef91f folded before Flop (didn't bet)
Seat 5: 2902f8c8 folded before Flop (didn't bet)
Seat 6: 52daa2a3 folded before Flop (didn't bet)


Poker Hand #HD50899053: Hold'em No Limit ($0.01/$0.02) - 2024/05/21 19:12:04
Table 'NLHYellow5' 6-max Seat #6 is the button
Seat 1: Hero ($2.26 in chips)
Seat 2: 5a5d73f ($3.07 in chips)
Seat 4: 471ef91f ($1.68 in chips)
Seat 5: 2902f8c8 ($3.42 in chips)
Seat 6: 52daa2a3 ($2.05 in chips)
Hero: posts small blind $0.01
5a5d73f: posts big blind $0.02
*** HOLE CARDS ***
Dealt to Hero [8s 3c]
Dealt to 5a5d73f 
Dealt to 471ef91f 
Dealt to 2902f8c8 
Dealt to 52daa2a3 
471ef91f: folds
2902f8c8: raises $0.03 to $0.05
52daa2a3: folds
Hero: folds
5a5d73f: folds
Uncalled bet ($0.03) returned to 2902f8c8
*** SHOWDOWN ***
2902f8c8 collected $0.05 from pot
*** SUMMARY ***
Total pot $0.05 | Rake $0 | Jackpot $0 | Bingo $0 | Fortune $0 | Tax $0
Seat 1: Hero (small blind) folded before Flop
Seat 2: 5a5d73f (big blind) folded before Flop
Seat 4: 471ef91f folded before Flop (didn't bet)
Seat 5: 2902f8c8 collected ($0.05)
Seat 6: 52daa2a3 (button) folded before Flop (didn't bet)


Poker Hand #HD50899022: Hold'em No Limit ($0.01/$0.02) - 2024/05/21 19:10:52
Table 'NLHYellow5' 6-max Seat #5 is the button
Seat 1: Hero ($2.28 in chips)
Seat 2: 5a5d73f ($3.09 in chips)
Seat 3: 9c4b3ea8 ($2.06 in chips)
Seat 4: 471ef91f ($1.68 in chips)
Seat 5: 2902f8c8 ($3.42 in chips)
Seat 6: 52daa2a3 ($1.92 in chips)
52daa2a3: posts small blind $0.01
Hero: posts big blind $0.02
*** HOLE CARDS ***
Dealt to Hero [2c Qd]
Dealt to 5a5d73f 
Dealt to 9c4b3ea8 
Dealt to 471ef91f 
Dealt to 2902f8c8 
Dealt to 52daa2a3 
5a5d73f: calls $0.02
9c4b3ea8: raises $0.02 to $0.04
471ef91f: folds
2902f8c8: folds
52daa2a3: raises $0.06 to $0.1
Hero: folds
5a5d73f: folds
9c4b3ea8: calls $0.06
*** FLOP *** [9c 9d 5h]
52daa2a3: bets $0.18
9c4b3ea8: folds
Uncalled bet ($0.18) returned to 52daa2a3
*** SHOWDOWN ***
52daa2a3 collected $0.23 from pot
*** SUMMARY ***
Total pot $0.24 | Rake $0.01 | Jackpot $0 | Bingo $0 | Fortune $0 | Tax $0
Board [9c 9d 5h]
Seat 1: Hero (big blind) folded before Flop
Seat 2: 5a5d73f folded before Flop
Seat 3: 9c4b3ea8 folded on the Flop
Seat 4: 471ef91f folded before Flop (didn't bet)
Seat 5: 2902f8c8 (button) folded before Flop (didn't bet)
Seat 6: 52daa2a3 (small blind) won ($0.23)


Poker Hand #HD50898995: Hold'em No Limit ($0.01/$0.02) - 2024/05/21 19:09:20
Table 'NLHYellow5' 6-max Seat #4 is the button
Seat 1: Hero ($2.28 in chips)
Seat 2: 5a5d73f ($3.12 in chips)
Seat 3: 9c4b3ea8 ($2 in chips)
Seat 4: 471ef91f ($1.68 in chips)
Seat 5: 2902f8c8 ($3.43 in chips)
Seat 6: 52daa2a3 ($1.94 in chips)
2902f8c8: posts small blind $0.01
52daa2a3: posts big blind $0.02
5a5d73f: posts missed blind $0.01
*** HOLE CARDS ***
Dealt to Hero [7c Ah]
Dealt to 5a5d73f 
Dealt to 9c4b3ea8 
Dealt to 471ef91f 
Dealt to 2902f8c8 
Dealt to 52daa2a3 
Hero: folds
5a5d73f: calls $0.02
9c4b3ea8: calls $0.02
471ef91f: folds
2902f8c8: folds
52daa2a3: checks
*** FLOP *** [3h Jh Jd]
52daa2a3: checks
5a5d73f: checks
9c4b3ea8: checks
*** TURN *** [3h Jh Jd] [8c]
52daa2a3: checks
5a5d73f: checks
9c4b3ea8: checks
*** RIVER *** [3h Jh Jd 8c] [8h]
52daa2a3: checks
5a5d73f: checks
9c4b3ea8: bets $0.04
52daa2a3: folds
5a5d73f: folds
Uncalled bet ($0.04) returned to 9c4b3ea8
*** SHOWDOWN ***
9c4b3ea8 collected $0.08 from pot
*** SUMMARY ***
Total pot $0.08 | Rake $0 | Jackpot $0 | Bingo $0 | Fortune $0 | Tax $0
Board [3h Jh Jd 8c 8h]
Seat 1: Hero folded before Flop (didn't bet)
Seat 2: 5a5d73f folded on the River
Seat 3: 9c4b3ea8 won ($0.08)
Seat 4: 471ef91f (button) folded before Flop (didn't bet)
Seat 5: 2902f8c8 (small blind) folded before Flop
Seat 6: 52daa2a3 (big blind) folded on the River


Poker Hand #HD50898977: Hold'em No Limit ($0.01/$0.02) - 2024/05/21 19:08:26
Table 'NLHYellow5' 6-max Seat #3 is the button
Seat 1: Hero ($2.28 in chips)
Seat 3: 9c4b3ea8 ($2 in chips)
Seat 4: 471ef91f ($1.7 in chips)
Seat 5: 2902f8c8 ($3.41 in chips)
Seat 6: 52daa2a3 ($1.94 in chips)
471ef91f: posts small blind $0.01
2902f8c8: posts big blind $0.02
*** HOLE CARDS ***
Dealt to Hero [9d 6c]
Dealt to 9c4b3ea8 
Dealt to 471ef91f 
Dealt to 2902f8c8 
Dealt to 52daa2a3 
52daa2a3: folds
Hero: folds
9c4b3ea8: folds
471ef91f: calls $0.01
2902f8c8: checks
*** FLOP *** [Th Qc 2s]
471ef91f: checks
2902f8c8: checks
*** TURN *** [Th Qc 2s] [5c]
471ef91f: checks
2902f8c8: checks
*** RIVER *** [Th Qc 2s 5c] [8c]
471ef91f: checks
2902f8c8: checks
471ef91f: shows [6d 9h] (Queen-High)
2902f8c8: shows [Jd 4h] (Queen-High)
*** SHOWDOWN ***
2902f8c8 collected $0.04 from pot
*** SUMMARY ***
Total pot $0.04 | Rake $0 | Jackpot $0 | Bingo $0 | Fortune $0 | Tax $0
Board [Th Qc 2s 5c 8c]
Seat 1: Hero folded before Flop (didn't bet)
Seat 3: 9c4b3ea8 (button) folded before Flop (didn't bet)
Seat 4: 471ef91f (small blind) showed [6d 9h] and lost with Queen-High
Seat 5: 2902f8c8 (big blind) showed [Jd 4h] and won ($0.04) with Queen-High
Seat 6: 52daa2a3 folded before Flop (didn't bet)


Poker Hand #HD50898967: Hold'em No Limit ($0.01/$0.02) - 2024/05/21 19:07:32
Table 'NLHYellow5' 6-max Seat #1 is the button
Seat 1: Hero ($2.09 in chips)
Seat 3: 9c4b3ea8 ($2 in chips)
Seat 4: 471ef91f ($1.72 in chips)
Seat 5: 2902f8c8 ($3.41 in chips)
Seat 6: 52daa2a3 ($1.94 in chips)
9c4b3ea8: posts small blind $0.01
471ef91f: posts big blind $0.02
*** HOLE CARDS ***
Dealt to Hero [Tc Js]
Dealt to 9c4b3ea8 
Dealt to 471ef91f 
Dealt to 2902f8c8 
Dealt to 52daa2a3 
2902f8c8: folds
52daa2a3: folds
Hero: raises $0.03 to $0.05
9c4b3ea8: calls $0.04
471ef91f: folds
*** FLOP *** [6c Qh 2d]
9c4b3ea8: checks
Hero: bets $0.04
9c4b3ea8: calls $0.04
*** TURN *** [6c Qh 2d] [8d]
9c4b3ea8: checks
Hero: bets $0.1
9c4b3ea8: calls $0.1
*** RIVER *** [6c Qh 2d 8d] [8h]
9c4b3ea8: checks
Hero: checks
9c4b3ea8: shows [4c 5c] (Pair of Eights)
Hero: shows [Tc Js] (Pair of Eights)
*** SHOWDOWN ***
Hero collected $0.38 from pot
*** SUMMARY ***
Total pot $0.4 | Rake $0.02 | Jackpot $0 | Bingo $0 | Fortune $0 | Tax $0
Board [6c Qh 2d 8d 8h]
Seat 1: Hero (button) showed [Tc Js] and won ($0.38) with Pair of Eights
Seat 3: 9c4b3ea8 (small blind) showed [4c 5c] and lost with Pair of Eights
Seat 4: 471ef91f (big blind) folded before Flop
Seat 5: 2902f8c8 folded before Flop (didn't bet)
Seat 6: 52daa2a3 folded before Flop (didn't bet)


Poker Hand #HD50898946: Hold'em No Limit ($0.01/$0.02) - 2024/05/21 19:06:46
Table 'NLHYellow5' 6-max Seat #6 is the button
Seat 1: Hero ($2.1 in chips)
Seat 2: 5a5d73f ($3.14 in chips)
Seat 3: 9c4b3ea8 ($2 in chips)
Seat 4: 471ef91f ($1.69 in chips)
Seat 5: 2902f8c8 ($3.41 in chips)
Seat 6: 52daa2a3 ($1.94 in chips)
Hero: posts small blind $0.01
5a5d73f: posts big blind $0.02
*** HOLE CARDS ***
Dealt to Hero [Th 5c]
Dealt to 5a5d73f 
Dealt to 9c4b3ea8 
Dealt to 471ef91f 
Dealt to 2902f8c8 
Dealt to 52daa2a3 
9c4b3ea8: folds
471ef91f: calls $0.02
2902f8c8: folds
52daa2a3: folds
Hero: folds
5a5d73f: checks
*** FLOP *** [3s Ad 6d]
5a5d73f: checks
471ef91f: bets $0.04
5a5d73f: folds
Uncalled bet ($0.04) returned to 471ef91f
*** SHOWDOWN ***
471ef91f collected $0.05 from pot
*** SUMMARY ***
Total pot $0.05 | Rake $0 | Jackpot $0 | Bingo $0 | Fortune $0 | Tax $0
Board [3s Ad 6d]
Seat 1: Hero (small blind) folded before Flop
Seat 2: 5a5d73f (big blind) folded on the Flop
Seat 3: 9c4b3ea8 folded before Flop (didn't bet)
Seat 4: 471ef91f won ($0.05)
Seat 5: 2902f8c8 folded before Flop (didn't bet)
Seat 6: 52daa2a3 (button) folded before Flop (didn't bet)


Poker Hand #HD50898907: Hold'em No Limit ($0.01/$0.02) - 2024/05/21 19:04:41
Table 'NLHYellow5' 6-max Seat #5 is the button
Seat 1: Hero ($2.03 in chips)
Seat 2: 5a5d73f ($3.16 in chips)
Seat 3: 9c4b3ea8 ($2 in chips)
Seat 4: 471ef91f ($1.69 in chips)
Seat 5: 2902f8c8 ($3.43 in chips)
Seat 6: 52daa2a3 ($1.95 in chips)
52daa2a3: posts small blind $0.01
Hero: posts big blind $0.02
*** HOLE CARDS ***
Dealt to Hero [2c Tc]
Dealt to 5a5d73f 
Dealt to 9c4b3ea8 
Dealt to 471ef91f 
Dealt to 2902f8c8 
Dealt to 52daa2a3 
5a5d73f: calls $0.02
9c4b3ea8: calls $0.02
471ef91f: folds
2902f8c8: calls $0.02
52daa2a3: folds
Hero: checks
*** FLOP *** [4h 4c Jd]
Hero: checks
5a5d73f: checks
9c4b3ea8: checks
2902f8c8: checks
*** TURN *** [4h 4c Jd] [Jc]
Hero: checks
5a5d73f: checks
9c4b3ea8: checks
2902f8c8: checks
*** RIVER *** [4h 4c Jd Jc] [6c]
Hero: checks
5a5d73f: checks
9c4b3ea8: checks
2902f8c8: checks
Hero: shows [2c Tc] (Jack High Flush)
5a5d73f: shows [8d Ac] (Pair of Jacks and Pair of Fours)
9c4b3ea8: shows [8h 9s] (Pair of Jacks and Pair of Fours)
2902f8c8: shows [Th Kd] (Pair of Jacks and Pair of Fours)
*** SHOWDOWN ***
Hero collected $0.09 from pot
*** SUMMARY ***
Total pot $0.09 | Rake $0 | Jackpot $0 | Bingo $0 | Fortune $0 | Tax $0
Board [4h 4c Jd Jc 6c]
Seat 1: Hero (big blind) showed [2c Tc] and won ($0.09) with Jack High Flush
Seat 2: 5a5d73f showed [8d Ac] and lost with Pair of Jacks and Pair of Fours
Seat 3: 9c4b3ea8 showed [8h 9s] and lost with Pair of Jacks and Pair of Fours
Seat 4: 471ef91f folded before Flop (didn't bet)
Seat 5: 2902f8c8 (button) showed [Th Kd] and lost with Pair of Jacks and Pair of Fours
Seat 6: 52daa2a3 (small blind) folded before Flop


Poker Hand #HD50898878: Hold'em No Limit ($0.01/$0.02) - 2024/05/21 19:03:23
Table 'NLHYellow5' 6-max Seat #4 is the button
Seat 1: Hero ($2.03 in chips)
Seat 2: 5a5d73f ($3.16 in chips)
Seat 3: 9c4b3ea8 ($2.19 in chips)
Seat 4: 471ef91f ($1.03 in chips)
Seat 5: 2902f8c8 ($3.44 in chips)
Seat 6: 52daa2a3 ($1.97 in chips)
2902f8c8: posts small blind $0.01
52daa2a3: posts big blind $0.02
*** HOLE CARDS ***
Dealt to Hero [6c 9s]
Dealt to 5a5d73f 
Dealt to 9c4b3ea8 
Dealt to 471ef91f 
Dealt to 2902f8c8 
Dealt to 52daa2a3 
Hero: folds
5a5d73f: folds
9c4b3ea8: calls $0.02
471ef91f: raises $0.06 to $0.08
2902f8c8: folds
52daa2a3: folds
9c4b3ea8: calls $0.06
*** FLOP *** [Ks Ts 7d]
9c4b3ea8: checks
471ef91f: bets $0.15
9c4b3ea8: calls $0.15
*** TURN *** [Ks Ts 7d] [2s]
9c4b3ea8: bets $0.49
471ef91f: calls $0.49
*** RIVER *** [Ks Ts 7d 2s] [8h]
9c4b3ea8: checks
471ef91f: checks
9c4b3ea8: shows [9h Th] (Pair of Tens)
471ef91f: shows [Qh Qs] (Pair of Queens)
*** SHOWDOWN ***
471ef91f collected $1.38 from pot
*** SUMMARY ***
Total pot $1.47 | Rake $0.07 | Jackpot $0.02 | Bingo $0 | Fortune $0 | Tax $0
Board [Ks Ts 7d 2s 8h]
Seat 1: Hero folded before Flop (didn't bet)
Seat 2: 5a5d73f folded before Flop (didn't bet)
Seat 3: 9c4b3ea8 showed [9h Th] and lost with Pair of Tens
Seat 4: 471ef91f (button) showed [Qh Qs] and won ($1.38) with Pair of Queens
Seat 5: 2902f8c8 (small blind) folded before Flop
Seat 6: 52daa2a3 (big blind) folded before Flop


Poker Hand #HD50898853: Hold'em No Limit ($0.01/$0.02) - 2024/05/21 19:02:22
Table 'NLHYellow5' 6-max Seat #3 is the button
Seat 1: Hero ($2.03 in chips)
Seat 2: 5a5d73f ($3.16 in chips)
Seat 3: 9c4b3ea8 ($2.04 in chips)
Seat 4: 471ef91f ($1.11 in chips)
Seat 5: 2902f8c8 ($3.52 in chips)
Seat 6: 52daa2a3 ($1.97 in chips)
471ef91f: posts small blind $0.01
2902f8c8: posts big blind $0.02
*** HOLE CARDS ***
Dealt to Hero [Th 5h]
Dealt to 5a5d73f 
Dealt to 9c4b3ea8 
Dealt to 471ef91f 
Dealt to 2902f8c8 
Dealt to 52daa2a3 
52daa2a3: folds
Hero: folds
5a5d73f: folds
9c4b3ea8: raises $0.06 to $0.08
471ef91f: calls $0.07
2902f8c8: calls $0.06
*** FLOP *** [As 8s 2s]
471ef91f: checks
2902f8c8: checks
9c4b3ea8: checks
*** TURN *** [As 8s 2s] [Qd]
471ef91f: checks
2902f8c8: checks
9c4b3ea8: bets $0.12
471ef91f: folds
2902f8c8: folds
Uncalled bet ($0.12) returned to 9c4b3ea8
*** SHOWDOWN ***
9c4b3ea8 collected $0.23 from pot
*** SUMMARY ***
Total pot $0.24 | Rake $0.01 | Jackpot $0 | Bingo $0 | Fortune $0 | Tax $0
Board [As 8s 2s Qd]
Seat 1: Hero folded before Flop (didn't bet)
Seat 2: 5a5d73f folded before Flop (didn't bet)
Seat 3: 9c4b3ea8 (button) won ($0.23)
Seat 4: 471ef91f (small blind) folded on the Turn
Seat 5: 2902f8c8 (big blind) folded on the Turn
Seat 6: 52daa2a3 folded before Flop (didn't bet)


Poker Hand #HD50898848: Hold'em No Limit ($0.01/$0.02) - 2024/05/21 19:02:04
Table 'NLHYellow5' 6-max Seat #2 is the button
Seat 1: Hero ($2.03 in chips)
Seat 2: 5a5d73f ($3.16 in chips)
Seat 3: 9c4b3ea8 ($2.02 in chips)
Seat 4: 471ef91f ($1.13 in chips)
Seat 5: 2902f8c8 ($3.52 in chips)
Seat 6: 52daa2a3 ($1.97 in chips)
9c4b3ea8: posts small blind $0.01
471ef91f: posts big blind $0.02
*** HOLE CARDS ***
Dealt to Hero [8d Ts]
Dealt to 5a5d73f 
Dealt to 9c4b3ea8 
Dealt to 471ef91f 
Dealt to 2902f8c8 
Dealt to 52daa2a3 
2902f8c8: folds
52daa2a3: folds
Hero: folds
5a5d73f: folds
9c4b3ea8: raises $0.06 to $0.08
471ef91f: folds
Uncalled bet ($0.06) returned to 9c4b3ea8
*** SHOWDOWN ***
9c4b3ea8 collected $0.04 from pot
*** SUMMARY ***
Total pot $0.04 | Rake $0 | Jackpot $0 | Bingo $0 | Fortune $0 | Tax $0
Seat 1: Hero folded before Flop (didn't bet)
Seat 2: 5a5d73f (button) folded before Flop (didn't bet)
Seat 3: 9c4b3ea8 (small blind) collected ($0.04)
Seat 4: 471ef91f (big blind) folded before Flop
Seat 5: 2902f8c8 folded before Flop (didn't bet)
Seat 6: 52daa2a3 folded before Flop (didn't bet)


Poker Hand #HD50898827: Hold'em No Limit ($0.01/$0.02) - 2024/05/21 19:01:04
Table 'NLHYellow5' 6-max Seat #1 is the button
Seat 1: Hero ($2.03 in chips)
Seat 2: 5a5d73f ($3.18 in chips)
Seat 3: 9c4b3ea8 ($2 in chips)
Seat 4: 471ef91f ($1.13 in chips)
Seat 5: 2902f8c8 ($3.52 in chips)
Seat 6: 52daa2a3 ($1.97 in chips)
5a5d73f: posts small blind $0.01
9c4b3ea8: posts big blind $0.02
*** HOLE CARDS ***
Dealt to Hero [7d Td]
Dealt to 5a5d73f 
Dealt to 9c4b3ea8 
Dealt to 471ef91f 
Dealt to 2902f8c8 
Dealt to 52daa2a3 
471ef91f: folds
2902f8c8: folds
52daa2a3: folds
Hero: folds
5a5d73f: calls $0.01
9c4b3ea8: checks
*** FLOP *** [6c 9s Th]
5a5d73f: checks
9c4b3ea8: checks
*** TURN *** [6c 9s Th] [4d]
5a5d73f: checks
9c4b3ea8: checks
*** RIVER *** [6c 9s Th 4d] [Qd]
5a5d73f: checks
9c4b3ea8: checks
5a5d73f: shows [2h 5h] (Queen-High)
9c4b3ea8: shows [8h 5d] (Queen-High)
*** SHOWDOWN ***
9c4b3ea8 collected $0.04 from pot
*** SUMMARY ***
Total pot $0.04 | Rake $0 | Jackpot $0 | Bingo $0 | Fortune $0 | Tax $0
Board [6c 9s Th 4d Qd]
Seat 1: Hero (button) folded before Flop (didn't bet)
Seat 2: 5a5d73f (small blind) showed [2h 5h] and lost with Queen-High
Seat 3: 9c4b3ea8 (big blind) showed [8h 5d] and won ($0.04) with Queen-High
Seat 4: 471ef91f folded before Flop (didn't bet)
Seat 5: 2902f8c8 folded before Flop (didn't bet)
Seat 6: 52daa2a3 folded before Flop (didn't bet)


Poker Hand #HD50898823: Hold'em No Limit ($0.01/$0.02) - 2024/05/21 19:00:55
Table 'NLHYellow5' 6-max Seat #6 is the button
Seat 1: Hero ($2.04 in chips)
Seat 2: 5a5d73f ($3.17 in chips)
Seat 3: 9c4b3ea8 ($2 in chips)
Seat 4: 471ef91f ($1.13 in chips)
Seat 5: 2902f8c8 ($3.52 in chips)
Seat 6: 52daa2a3 ($1.97 in chips)
Hero: posts small blind $0.01
5a5d73f: posts big blind $0.02
*** HOLE CARDS ***
Dealt to Hero [Kh 2h]
Dealt to 5a5d73f 
Dealt to 9c4b3ea8 
Dealt to 471ef91f 
Dealt to 2902f8c8 
Dealt to 52daa2a3 
9c4b3ea8: folds
471ef91f: folds
2902f8c8: folds
52daa2a3: folds
Hero: folds
Uncalled bet ($0.01) returned to 5a5d73f
*** SHOWDOWN ***
5a5d73f collected $0.02 from pot
*** SUMMARY ***
Total pot $0.02 | Rake $0 | Jackpot $0 | Bingo $0 | Fortune $0 | Tax $0
Seat 1: Hero (small blind) folded before Flop
Seat 2: 5a5d73f (big blind) collected ($0.02)
Seat 3: 9c4b3ea8 folded before Flop (didn't bet)
Seat 4: 471ef91f folded before Flop (didn't bet)
Seat 5: 2902f8c8 folded before Flop (didn't bet)
Seat 6: 52daa2a3 (button) folded before Flop (didn't bet)


Poker Hand #HD50898784: Hold'em No Limit ($0.01/$0.02) - 2024/05/21 18:59:20
Table 'NLHYellow5' 6-max Seat #5 is the button
Seat 1: Hero ($2.1 in chips)
Seat 2: 5a5d73f ($3.05 in chips)
Seat 3: 9c4b3ea8 ($2 in chips)
Seat 4: 471ef91f ($1.13 in chips)
Seat 5: 2902f8c8 ($3.58 in chips)
Seat 6: 52daa2a3 ($1.98 in chips)
52daa2a3: posts small blind $0.01
Hero: posts big blind $0.02
*** HOLE CARDS ***
Dealt to Hero [Jc Td]
Dealt to 5a5d73f 
Dealt to 9c4b3ea8 
Dealt to 471ef91f 
Dealt to 2902f8c8 
Dealt to 52daa2a3 
5a5d73f: calls $0.02
9c4b3ea8: folds
471ef91f: folds
2902f8c8: raises $0.04 to $0.06
52daa2a3: folds
Hero: calls $0.04
5a5d73f: calls $0.04
*** FLOP *** [6h 3s 3d]
Hero: checks
5a5d73f: checks
2902f8c8: checks
*** TURN *** [6h 3s 3d] [2d]
Hero: checks
5a5d73f: checks
2902f8c8: checks
*** RIVER *** [6h 3s 3d 2d] [6s]
Hero: checks
5a5d73f: checks
2902f8c8: checks
Hero: shows [Jc Td] (Pair of Sixes and Pair of Treys)
5a5d73f: shows [Jh Ad] (Pair of Sixes and Pair of Treys)
2902f8c8: shows [9h Th] (Pair of Sixes and Pair of Treys)
*** SHOWDOWN ***
5a5d73f collected $0.18 from pot
*** SUMMARY ***
Total pot $0.19 | Rake $0.01 | Jackpot $0 | Bingo $0 | Fortune $0 | Tax $0
Board [6h 3s 3d 2d 6s]
Seat 1: Hero (big blind) showed [Jc Td] and lost with Pair of Sixes and Pair of Treys
Seat 2: 5a5d73f showed [Jh Ad] and won ($0.18) with Pair of Sixes and Pair of Treys
Seat 3: 9c4b3ea8 folded before Flop (didn't bet)
Seat 4: 471ef91f folded before Flop (didn't bet)
Seat 5: 2902f8c8 (button) showed [9h Th] and lost with Pair of Sixes and Pair of Treys
Seat 6: 52daa2a3 (small blind) folded before Flop


Poker Hand #HD50898768: Hold'em No Limit ($0.01/$0.02) - 2024/05/21 18:58:41
Table 'NLHYellow5' 6-max Seat #4 is the button
Seat 1: Hero ($2.1 in chips)
Seat 2: 5a5d73f ($3.07 in chips)
Seat 3: 9c4b3ea8 ($2 in chips)
Seat 4: 471ef91f ($1.13 in chips)
Seat 5: 2902f8c8 ($3.52 in chips)
Seat 6: 52daa2a3 ($2 in chips)
2902f8c8: posts small blind $0.01
52daa2a3: posts big blind $0.02
*** HOLE CARDS ***
Dealt to Hero [Ah 4s]
Dealt to 5a5d73f 
Dealt to 9c4b3ea8 
Dealt to 471ef91f 
Dealt to 2902f8c8 
Dealt to 52daa2a3 
Hero: folds
5a5d73f: calls $0.02
9c4b3ea8: calls $0.02
471ef91f: folds
2902f8c8: raises $0.06 to $0.08
52daa2a3: folds
5a5d73f: folds
9c4b3ea8: folds
Uncalled bet ($0.06) returned to 2902f8c8
*** SHOWDOWN ***
2902f8c8 collected $0.08 from pot
*** SUMMARY ***
Total pot $0.08 | Rake $0 | Jackpot $0 | Bingo $0 | Fortune $0 | Tax $0
Seat 1: Hero folded before Flop (didn't bet)
Seat 2: 5a5d73f folded before Flop
Seat 3: 9c4b3ea8 folded before Flop
Seat 4: 471ef91f (button) folded before Flop (didn't bet)
Seat 5: 2902f8c8 (small blind) collected ($0.08)
Seat 6: 52daa2a3 (big blind) folded before Flop


Poker Hand #HD50898744: Hold'em No Limit ($0.01/$0.02) - 2024/05/21 18:57:36
Table 'NLHYellow5' 6-max Seat #3 is the button
Seat 1: Hero ($2.1 in chips)
Seat 2: 5a5d73f ($2.97 in chips)
Seat 3: 9c4b3ea8 ($2 in chips)
Seat 4: 471ef91f ($1.15 in chips)
Seat 5: 2902f8c8 ($3.54 in chips)
471ef91f: posts small blind $0.01
2902f8c8: posts big blind $0.02
*** HOLE CARDS ***
Dealt to Hero [7s Ts]
Dealt to 5a5d73f 
Dealt to 9c4b3ea8 
Dealt to 471ef91f 
Dealt to 2902f8c8 
Hero: folds
5a5d73f: calls $0.02
9c4b3ea8: calls $0.02
471ef91f: calls $0.01
2902f8c8: checks
*** FLOP *** [6c Qs 6h]
471ef91f: checks
2902f8c8: checks
5a5d73f: checks
9c4b3ea8: bets $0.04
471ef91f: folds
2902f8c8: folds
5a5d73f: raises $0.62 to $0.66
9c4b3ea8: folds
Uncalled bet ($0.62) returned to 5a5d73f
5a5d73f: shows [Ad]
*** SHOWDOWN ***
5a5d73f collected $0.16 from pot
*** SUMMARY ***
Total pot $0.16 | Rake $0 | Jackpot $0 | Bingo $0 | Fortune $0 | Tax $0
Board [6c Qs 6h]
Seat 1: Hero folded before Flop (didn't bet)
Seat 2: 5a5d73f showed [Ad] and won ($0.16)
Seat 3: 9c4b3ea8 (button) folded on the Flop
Seat 4: 471ef91f (small blind) folded on the Flop
Seat 5: 2902f8c8 (big blind) folded on the Flop


Poker Hand #HD50898720: Hold'em No Limit ($0.01/$0.02) - 2024/05/21 18:56:49
Table 'NLHYellow5' 6-max Seat #2 is the button
Seat 1: Hero ($2 in chips)
Seat 2: 5a5d73f ($2.97 in chips)
Seat 3: 9c4b3ea8 ($2 in chips)
Seat 4: 471ef91f ($1.2 in chips)
Seat 5: 2902f8c8 ($3.54 in chips)
9c4b3ea8: posts small blind $0.01
471ef91f: posts big blind $0.02
*** HOLE CARDS ***
Dealt to Hero [As Tc]
Dealt to 5a5d73f 
Dealt to 9c4b3ea8 
Dealt to 471ef91f 
Dealt to 2902f8c8 
2902f8c8: folds
Hero: raises $0.03 to $0.05
5a5d73f: folds
9c4b3ea8: calls $0.04
471ef91f: calls $0.03
*** FLOP *** [7s Ac Qd]
9c4b3ea8: checks
471ef91f: checks
Hero: bets $0.08
9c4b3ea8: folds
471ef91f: folds
Uncalled bet ($0.08) returned to Hero
*** SHOWDOWN ***
Hero collected $0.15 from pot
*** SUMMARY ***
Total pot $0.15 | Rake $0 | Jackpot $0 | Bingo $0 | Fortune $0 | Tax $0
Board [7s Ac Qd]
Seat 1: Hero won ($0.15)
Seat 2: 5a5d73f (button) folded before Flop (didn't bet)
Seat 3: 9c4b3ea8 (small blind) folded on the Flop
Seat 4: 471ef91f (big blind) folded on the Flop
Seat 5: 2902f8c8 folded before Flop (didn't bet)


Poker Hand #HD50898713: Hold'em No Limit ($0.01/$0.02) - 2024/05/21 18:56:37
Table 'NLHYellow5' 6-max Seat #1 is the button
Seat 1: Hero ($1.97 in chips)
Seat 2: 5a5d73f ($2.98 in chips)
Seat 3: 9c4b3ea8 ($2 in chips)
Seat 4: 471ef91f ($1.2 in chips)
Seat 5: 2902f8c8 ($3.54 in chips)
5a5d73f: posts small blind $0.01
9c4b3ea8: posts big blind $0.02
*** HOLE CARDS ***
Dealt to Hero [4h 4c]
Dealt to 5a5d73f 
Dealt to 9c4b3ea8 
Dealt to 471ef91f 
Dealt to 2902f8c8 
471ef91f: folds
2902f8c8: folds
Hero: raises $0.03 to $0.05
5a5d73f: folds
9c4b3ea8: folds
Uncalled bet ($0.03) returned to Hero
*** SHOWDOWN ***
Hero collected $0.05 from pot
*** SUMMARY ***
Total pot $0.05 | Rake $0 | Jackpot $0 | Bingo $0 | Fortune $0 | Tax $0
Seat 1: Hero (button) collected ($0.05)
Seat 2: 5a5d73f (small blind) folded before Flop
Seat 3: 9c4b3ea8 (big blind) folded before Flop
Seat 4: 471ef91f folded before Flop (didn't bet)
Seat 5: 2902f8c8 folded before Flop (didn't bet)


Poker Hand #HD50898693: Hold'em No Limit ($0.01/$0.02) - 2024/05/21 18:55:42
Table 'NLHYellow5' 6-max Seat #6 is the button
Seat 1: Hero ($1.98 in chips)
Seat 2: 5a5d73f ($2.56 in chips)
Seat 3: 9c4b3ea8 ($2 in chips)
Seat 4: 471ef91f ($1.2 in chips)
Seat 5: 2902f8c8 ($3.54 in chips)
Seat 6: f53afb66 ($0.45 in chips)
Hero: posts small blind $0.01
5a5d73f: posts big blind $0.02
*** HOLE CARDS ***
Dealt to Hero [Js 5c]
Dealt to 5a5d73f 
Dealt to 9c4b3ea8 
Dealt to 471ef91f 
Dealt to 2902f8c8 
Dealt to f53afb66 
9c4b3ea8: calls $0.02
471ef91f: folds
2902f8c8: folds
f53afb66: calls $0.02
Hero: folds
5a5d73f: checks
*** FLOP *** [Ad 6s 9s]
5a5d73f: checks
9c4b3ea8: checks
f53afb66: checks
*** TURN *** [Ad 6s 9s] [6c]
5a5d73f: checks
9c4b3ea8: checks
f53afb66: checks
*** RIVER *** [Ad 6s 9s 6c] [6d]
5a5d73f: checks
9c4b3ea8: checks
f53afb66: bets $0.43 and is all-in
5a5d73f: calls $0.43
9c4b3ea8: folds
f53afb66: shows [Qh 9d] (Sixes Full over Nines)
5a5d73f: shows [Ac 5h] (Sixes Full over Aces)
*** SHOWDOWN ***
5a5d73f collected $0.87 from pot
*** SUMMARY ***
Total pot $0.93 | Rake $0.04 | Jackpot $0.02 | Bingo $0 | Fortune $0 | Tax $0
Board [Ad 6s 9s 6c 6d]
Seat 1: Hero (small blind) folded before Flop
Seat 2: 5a5d73f (big blind) showed [Ac 5h] and won ($0.87) with Sixes Full over Aces
Seat 3: 9c4b3ea8 folded on the River
Seat 4: 471ef91f folded before Flop (didn't bet)
Seat 5: 2902f8c8 folded before Flop (didn't bet)
Seat 6: f53afb66 (button) showed [Qh 9d] and lost with Sixes Full over Nines


Poker Hand #HD50898668: Hold'em No Limit ($0.01/$0.02) - 2024/05/21 18:54:28
Table 'NLHYellow5' 6-max Seat #5 is the button
Seat 1: Hero ($2 in chips)
Seat 2: 5a5d73f ($1.98 in chips)
Seat 3: 9c4b3ea8 ($2.05 in chips)
Seat 4: 471ef91f ($1.2 in chips)
Seat 5: 2902f8c8 ($3.54 in chips)
Seat 6: f53afb66 ($0.76 in chips)
f53afb66: posts small blind $0.01
Hero: posts big blind $0.02
*** HOLE CARDS ***
Dealt to Hero [3s Jh]
Dealt to 5a5d73f 
Dealt to 9c4b3ea8 
Dealt to 471ef91f 
Dealt to 2902f8c8 
Dealt to f53afb66 
5a5d73f: calls $0.02
9c4b3ea8: calls $0.02
471ef91f: folds
2902f8c8: folds
f53afb66: calls $0.01
Hero: checks
*** FLOP *** [Kc 7s Qs]
f53afb66: checks
Hero: checks
5a5d73f: checks
9c4b3ea8: checks
*** TURN *** [Kc 7s Qs] [9s]
f53afb66: bets $0.04
Hero: folds
5a5d73f: calls $0.04
9c4b3ea8: calls $0.04
*** RIVER *** [Kc 7s Qs 9s] [8h]
f53afb66: checks
5a5d73f: bets $0.25
9c4b3ea8: calls $0.25
f53afb66: calls $0.25
5a5d73f: shows [Th Jd] (Kings-High Straight)
9c4b3ea8: shows [8s Qh] (Pair of Queens and Pair of Eights)
f53afb66: shows [9c Ts] (Pair of Nines)
*** SHOWDOWN ***
5a5d73f collected $0.89 from pot
*** SUMMARY ***
Total pot $0.95 | Rake $0.04 | Jackpot $0.02 | Bingo $0 | Fortune $0 | Tax $0
Board [Kc 7s Qs 9s 8h]
Seat 1: Hero (big blind) folded on the Turn
Seat 2: 5a5d73f showed [Th Jd] and won ($0.89) with Kings-High Straight
Seat 3: 9c4b3ea8 showed [8s Qh] and lost with Pair of Queens and Pair of Eights
Seat 4: 471ef91f folded before Flop (didn't bet)
Seat 5: 2902f8c8 (button) folded before Flop (didn't bet)
Seat 6: f53afb66 (small blind) showed [9c Ts] and lost with Pair of Nines


